InvoiceId,InvoiceDate,CustomerId,AddressId,TaxBase,TotalVat,Total
1,2021-08-31,1,2,1000,210,1210
2,2021-11-13,1,1,2000,420,2420
3,2023-01-23,1,1,3000,630,3630
4,2023-04-12,1,3,4000,840,4840
5,2020-11-03,2,2,5000,1050,6050
6,2024-10-25,1,2,6000,1260,7260
7,2020-03-23,2,1,7000,1470,8470
8,2020-09-23,1,1,8000,1680,9680
9,2020-09-18,1,1,9000,1890,10890
10,2022-12-02,3,1,10000,2100,12100
11,2022-07-14,2,1,11000,2310,13310
12,2021-12-02,3,2,12000,2520,14520
13,2022-11-26,2,2,13000,2730,15730
14,2023-02-18,1,3,14000,2940,16940
15,2020-04-30,3,1,15000,3150,18150
16,2024-09-04,3,1,16000,3360,19360
17,2023-05-18,3,2,17000,3570,20570
18,2024-06-13,2,3,18000,3780,21780
19,2024-06-05,3,2,19000,3990,22990
20,2020-07-15,1,1,20000,4200,24200
21,2020-09-17,1,3,21000,4410,25410
22,2020-05-11,2,3,22000,4620,26620
23,2022-06-14,1,1,23000,4830,27830
24,2023-06-18,2,3,24000,5040,29040
25,2021-10-19,2,2,25000,5250,30250
26,2020-01-23,2,2,26000,5460,31460
27,2024-03-07,3,3,27000,5670,32670
28,2021-04-27,3,1,28000,5880,33880
29,2022-03-23,3,2,29000,6090,35090
30,2020-06-03,1,3,30000,6300,36300
31,2020-02-03,3,1,31000,6510,37510
32,2022-09-18,2,3,32000,6720,38720
33,2022-12-25,3,1,33000,6930,39930
34,2023-11-11,3,2,34000,7140,41140
35,2024-09-21,1,3,35000,7350,42350
36,2021-08-04,1,3,36000,7560,43560
37,2020-07-07,3,2,37000,7770,44770
38,2024-08-12,2,1,38000,7980,45980
39,2022-11-14,1,1,39000,8190,47190
40,2023-08-17,2,1,40000,8400,48400
41,2022-04-30,3,3,41000,8610,49610
42,2021-07-06,1,2,42000,8820,50820
43,2020-09-25,1,1,43000,9030,52030
44,2024-06-20,3,3,44000,9240,53240
45,2022-06-03,3,2,45000,9450,54450
46,2024-11-29,2,3,46000,9660,55660
47,2023-05-16,1,1,47000,9870,56870
48,2022-12-24,2,3,48000,10080,58080
49,2022-11-30,1,1,49000,10290,59290
50,2022-10-08,2,2,50000,10500,60500
51,2023-08-03,3,1,51000,10710,61710
52,2022-02-03,1,1,52000,10920,62920
53,2024-11-05,1,3,53000,11130,64130
54,2024-03-06,3,3,54000,11340,65340
55,2024-10-16,1,2,55000,11550,66550
56,2022-05-25,1,1,56000,11760,67760
57,2022-07-28,1,1,57000,11970,68970
58,2021-05-24,1,1,58000,12180,70180
59,2022-06-03,2,2,59000,12390,71390
60,2022-07-15,3,3,60000,12600,72600
61,2023-07-28,2,3,61000,12810,73810
62,2021-09-02,3,2,62000,13020,75020
63,2021-02-26,1,3,63000,13230,76230
64,2020-05-12,3,3,64000,13440,77440
65,2021-03-31,2,2,65000,13650,78650
66,2021-05-03,1,3,66000,13860,79860
67,2022-11-20,2,1,67000,14070,81070
68,2024-09-23,3,1,68000,14280,82280
69,2024-07-08,2,3,69000,14490,83490
70,2021-09-04,2,1,70000,14700,84700
71,2020-04-25,1,1,71000,14910,85910
72,2021-04-12,1,2,72000,15120,87120
73,2024-12-13,3,2,73000,15330,88330
74,2021-09-04,1,2,74000,15540,89540
75,2023-11-10,3,1,75000,15750,90750
76,2024-03-25,3,1,76000,15960,91960
77,2021-04-10,2,3,77000,16170,93170
78,2023-03-11,2,3,78000,16380,94380
79,2024-11-26,1,3,79000,16590,95590
80,2021-11-07,3,3,80000,16800,96800
81,2020-03-14,3,1,81000,17010,98010
82,2021-03-10,3,1,82000,17220,99220
83,2024-01-29,2,1,83000,17430,100430
84,2024-08-16,3,3,84000,17640,101640
85,2022-05-03,1,3,85000,17850,102850
86,2024-05-08,3,3,86000,18060,104060
87,2021-03-18,3,3,87000,18270,105270
88,2021-07-17,1,1,88000,18480,106480
89,2022-02-18,3,1,89000,18690,107690
90,2022-11-14,2,2,90000,18900,108900
91,2024-10-30,1,1,91000,19110,110110
92,2021-06-26,3,3,92000,19320,111320
93,2024-06-10,1,2,93000,19530,112530
94,2022-01-26,3,2,94000,19740,113740
95,2020-09-25,1,3,95000,19950,114950
96,2022-10-28,2,2,96000,20160,116160
97,2023-04-19,2,2,97000,20370,117370
98,2021-05-29,2,1,98000,20580,118580
99,2022-12-01,2,3,99000,20790,119790
100,2022-03-12,3,1,100000,21000,121000
101,2024-02-05,1,2,101000,21210,122210
102,2023-12-25,2,3,102000,21420,123420
103,2022-01-08,2,1,103000,21630,124630
104,2021-07-18,1,3,104000,21840,125840
105,2024-01-10,2,3,105000,22050,127050
106,2023-01-20,1,2,106000,22260,128260
107,2020-01-14,1,2,107000,22470,129470
108,2023-10-03,3,1,108000,22680,130680
109,2023-04-18,2,3,109000,22890,131890
110,2024-10-30,2,3,110000,23100,133100
111,2020-03-26,1,3,111000,23310,134310
112,2022-06-09,1,1,112000,23520,135520
113,2021-06-24,1,3,113000,23730,136730
114,2023-10-14,2,3,114000,23940,137940
115,2020-05-09,1,3,115000,24150,139150
116,2021-09-09,3,1,116000,24360,140360
117,2020-06-12,3,1,117000,24570,141570
118,2023-04-30,1,3,118000,24780,142780
119,2023-06-03,1,3,119000,24990,143990
120,2022-09-23,3,3,120000,25200,145200
121,2022-03-05,2,3,121000,25410,146410
122,2023-08-14,1,2,122000,25620,147620
123,2021-03-30,1,2,123000,25830,148830
124,2021-11-27,1,3,124000,26040,150040
125,2022-05-29,2,2,125000,26250,151250
126,2020-06-23,1,3,126000,26460,152460
127,2024-09-18,1,1,127000,26670,153670
128,2020-12-11,1,3,128000,26880,154880
129,2021-10-29,3,3,129000,27090,156090
130,2022-04-16,2,1,130000,27300,157300
131,2020-01-06,3,3,131000,27510,158510
132,2022-05-29,2,3,132000,27720,159720
133,2023-07-12,1,3,133000,27930,160930
134,2021-01-21,2,3,134000,28140,162140
135,2022-03-18,2,2,135000,28350,163350
136,2022-07-23,3,1,136000,28560,164560
137,2023-10-18,3,2,137000,28770,165770
138,2020-07-20,2,1,138000,28980,166980
139,2024-01-25,1,2,139000,29190,168190
140,2020-05-10,3,3,140000,29400,169400
141,2024-06-26,2,2,141000,29610,170610
142,2024-04-19,2,2,142000,29820,171820
143,2020-06-10,3,1,143000,30030,173030
144,2022-05-13,1,1,144000,30240,174240
145,2023-10-29,3,3,145000,30450,175450
146,2022-02-12,3,3,146000,30660,176660
147,2021-09-10,3,2,147000,30870,177870
148,2021-05-09,2,2,148000,31080,179080
149,2023-03-02,1,1,149000,31290,180290
150,2024-10-07,1,1,150000,31500,181500
151,2023-01-27,2,1,151000,31710,182710
152,2021-09-26,1,2,152000,31920,183920
153,2021-08-23,1,1,153000,32130,185130
154,2024-09-28,2,3,154000,32340,186340
155,2020-07-01,3,1,155000,32550,187550
156,2024-11-09,2,3,156000,32760,188760
157,2023-06-30,3,2,157000,32970,189970
158,2020-11-26,1,1,158000,33180,191180
159,2024-06-14,3,1,159000,33390,192390
160,2022-09-14,2,1,160000,33600,193600
161,2020-04-28,3,1,161000,33810,194810
162,2023-11-25,3,3,162000,34020,196020
163,2020-05-06,2,1,163000,34230,197230
164,2024-04-24,2,2,164000,34440,198440
165,2020-06-12,3,2,165000,34650,199650
166,2024-06-07,3,3,166000,34860,200860
167,2022-06-24,1,1,167000,35070,202070
168,2023-06-05,3,3,168000,35280,203280
169,2022-10-19,1,3,169000,35490,204490
170,2022-04-24,2,3,170000,35700,205700
171,2023-04-30,1,1,171000,35910,206910
172,2024-03-31,1,3,172000,36120,208120
173,2024-02-02,2,1,173000,36330,209330
174,2020-08-12,2,1,174000,36540,210540
175,2024-06-05,2,1,175000,36750,211750
176,2022-09-06,2,2,176000,36960,212960
177,2020-10-23,2,1,177000,37170,214170
178,2022-12-07,3,1,178000,37380,215380
179,2023-05-20,1,3,179000,37590,216590
180,2020-09-20,2,3,180000,37800,217800
181,2023-10-21,3,3,181000,38010,219010
182,2021-02-10,3,3,182000,38220,220220
183,2020-10-19,3,1,183000,38430,221430
184,2023-11-20,3,3,184000,38640,222640
185,2021-12-10,1,2,185000,38850,223850
186,2024-04-28,1,3,186000,39060,225060
187,2021-02-27,2,1,187000,39270,226270
188,2020-04-02,3,1,188000,39480,227480
189,2024-02-13,3,1,189000,39690,228690
190,2021-04-12,2,1,190000,39900,229900
191,2020-06-28,2,2,191000,40110,231110
192,2022-04-01,1,2,192000,40320,232320
193,2023-12-27,2,1,193000,40530,233530
194,2023-11-06,1,1,194000,40740,234740
195,2024-04-26,1,1,195000,40950,235950
196,2024-11-02,3,2,196000,41160,237160
197,2020-02-16,3,3,197000,41370,238370
198,2024-01-23,3,3,198000,41580,239580
199,2023-04-08,2,2,199000,41790,240790
200,2021-04-04,3,1,200000,42000,242000
201,2020-11-29,2,2,201000,42210,243210
202,2024-05-31,3,3,202000,42420,244420
203,2022-03-10,2,3,203000,42630,245630
204,2024-02-16,3,2,204000,42840,246840
205,2022-09-17,1,1,205000,43050,248050
206,2024-10-29,2,1,206000,43260,249260
207,2024-01-09,2,2,207000,43470,250470
208,2020-07-03,2,3,208000,43680,251680
209,2024-11-03,1,2,209000,43890,252890
210,2020-09-26,3,3,210000,44100,254100
211,2024-09-16,2,2,211000,44310,255310
212,2022-12-29,1,3,212000,44520,256520
213,2022-12-19,3,2,213000,44730,257730
214,2023-07-21,2,3,214000,44940,258940
215,2020-05-20,2,3,215000,45150,260150
216,2021-04-15,1,2,216000,45360,261360
217,2024-09-04,3,2,217000,45570,262570
218,2022-07-05,2,3,218000,45780,263780
219,2024-05-02,2,2,219000,45990,264990
220,2022-04-23,3,2,220000,46200,266200
221,2022-06-12,3,2,221000,46410,267410
222,2020-03-01,1,3,222000,46620,268620
223,2022-10-16,1,3,223000,46830,269830
224,2023-07-07,3,3,224000,47040,271040
225,2020-07-30,3,1,225000,47250,272250
226,2024-12-27,3,1,226000,47460,273460
227,2020-07-05,2,2,227000,47670,274670
228,2024-11-09,1,1,228000,47880,275880
229,2021-11-10,2,3,229000,48090,277090
230,2021-10-27,1,2,230000,48300,278300
231,2021-09-14,1,2,231000,48510,279510
232,2021-04-02,2,3,232000,48720,280720
233,2023-04-30,2,1,233000,48930,281930
234,2020-04-02,1,1,234000,49140,283140
235,2022-11-16,1,3,235000,49350,284350
236,2024-05-23,2,3,236000,49560,285560
237,2024-11-27,2,2,237000,49770,286770
238,2023-06-24,3,1,238000,49980,287980
239,2023-04-30,2,2,239000,50190,289190
240,2020-12-18,1,1,240000,50400,290400
241,2021-05-08,2,3,241000,50610,291610
242,2022-04-10,2,3,242000,50820,292820
243,2024-03-08,2,2,243000,51030,294030
244,2024-11-02,3,2,244000,51240,295240
245,2020-04-26,1,3,245000,51450,296450
246,2021-09-06,1,3,246000,51660,297660
247,2020-02-09,2,1,247000,51870,298870
248,2024-10-16,3,2,248000,52080,300080
249,2020-12-07,3,1,249000,52290,301290
250,2022-10-12,2,1,250000,52500,302500
251,2022-05-28,2,2,251000,52710,303710
252,2020-07-09,1,3,252000,52920,304920
253,2021-10-24,3,1,253000,53130,306130
254,2024-03-21,2,2,254000,53340,307340
255,2024-06-19,2,2,255000,53550,308550
256,2022-04-03,3,2,256000,53760,309760
257,2021-03-06,1,1,257000,53970,310970
258,2020-07-09,1,3,258000,54180,312180
259,2020-09-01,1,1,259000,54390,313390
260,2022-03-05,1,3,260000,54600,314600
261,2020-06-23,2,2,261000,54810,315810
262,2022-02-25,2,1,262000,55020,317020
263,2020-09-03,2,1,263000,55230,318230
264,2023-06-22,1,2,264000,55440,319440
265,2022-12-22,3,1,265000,55650,320650
266,2024-07-20,3,1,266000,55860,321860
267,2024-04-29,1,2,267000,56070,323070
268,2022-11-14,1,3,268000,56280,324280
269,2021-01-21,3,3,269000,56490,325490
270,2023-01-18,2,1,270000,56700,326700
271,2024-05-24,3,1,271000,56910,327910
272,2023-03-11,2,3,272000,57120,329120
273,2024-09-28,1,3,273000,57330,330330
274,2024-07-31,2,2,274000,57540,331540
275,2023-09-12,3,1,275000,57750,332750
276,2021-08-10,3,2,276000,57960,333960
277,2021-01-10,1,3,277000,58170,335170
278,2024-11-05,1,3,278000,58380,336380
279,2022-09-29,1,1,279000,58590,337590
280,2024-10-14,1,1,280000,58800,338800
281,2024-05-04,3,1,281000,59010,340010
282,2024-11-07,1,1,282000,59220,341220
283,2022-08-29,1,3,283000,59430,342430
284,2020-10-12,2,3,284000,59640,343640
285,2020-01-07,3,3,285000,59850,344850
286,2022-07-03,1,2,286000,60060,346060
287,2024-05-16,2,1,287000,60270,347270
288,2021-12-25,2,1,288000,60480,348480
289,2021-02-04,3,2,289000,60690,349690
290,2023-02-10,2,3,290000,60900,350900
291,2020-04-29,3,3,291000,61110,352110
292,2021-08-23,2,2,292000,61320,353320
293,2021-10-27,1,1,293000,61530,354530
294,2023-06-04,3,3,294000,61740,355740
295,2021-04-08,2,3,295000,61950,356950
296,2023-04-15,3,2,296000,62160,358160
297,2023-03-30,3,2,297000,62370,359370
298,2020-12-26,2,1,298000,62580,360580
299,2023-02-09,2,2,299000,62790,361790
300,2024-09-20,3,1,300000,63000,363000
301,2020-10-07,1,2,301000,63210,364210
302,2023-12-04,1,3,302000,63420,365420
303,2023-12-09,1,2,303000,63630,366630
304,2020-08-13,3,2,304000,63840,367840
305,2021-03-12,2,2,305000,64050,369050
306,2024-08-07,3,3,306000,64260,370260
307,2021-12-28,2,1,307000,64470,371470
308,2023-05-23,1,1,308000,64680,372680
309,2024-05-18,3,2,309000,64890,373890
310,2021-10-11,2,2,310000,65100,375100
311,2020-01-13,1,2,311000,65310,376310
312,2021-05-03,1,3,312000,65520,377520
313,2020-02-07,3,2,313000,65730,378730
314,2024-09-08,3,1,314000,65940,379940
315,2020-07-29,1,2,315000,66150,381150
316,2023-01-02,3,3,316000,66360,382360
317,2020-06-19,2,1,317000,66570,383570
318,2023-09-28,2,1,318000,66780,384780
319,2023-01-13,1,1,319000,66990,385990
320,2024-08-15,3,2,320000,67200,387200
321,2024-08-25,2,2,321000,67410,388410
322,2024-10-28,2,1,322000,67620,389620
323,2021-01-13,1,2,323000,67830,390830
324,2022-08-20,1,3,324000,68040,392040
325,2024-05-25,3,1,325000,68250,393250
326,2023-06-21,3,1,326000,68460,394460
327,2024-07-17,1,1,327000,68670,395670
328,2023-07-28,2,2,328000,68880,396880
329,2024-01-08,1,3,329000,69090,398090
330,2021-06-19,1,1,330000,69300,399300
331,2024-08-08,2,1,331000,69510,400510
332,2022-12-22,3,2,332000,69720,401720
333,2020-06-10,3,3,333000,69930,402930
334,2024-10-11,1,1,334000,70140,404140
335,2020-09-18,1,1,335000,70350,405350
336,2021-02-12,1,3,336000,70560,406560
337,2021-01-03,1,2,337000,70770,407770
338,2022-07-11,1,2,338000,70980,408980
339,2020-08-09,1,3,339000,71190,410190
340,2021-10-05,3,1,340000,71400,411400
341,2022-05-01,3,3,341000,71610,412610
342,2021-12-24,3,1,342000,71820,413820
343,2023-11-06,1,2,343000,72030,415030
344,2023-02-04,1,1,344000,72240,416240
345,2022-01-16,2,3,345000,72450,417450
346,2021-04-12,3,1,346000,72660,418660
347,2020-12-17,1,3,347000,72870,419870
348,2022-04-22,1,1,348000,73080,421080
349,2022-02-14,3,3,349000,73290,422290
350,2023-05-22,1,2,350000,73500,423500
351,2023-06-21,1,3,351000,73710,424710
352,2021-12-08,2,2,352000,73920,425920
353,2020-12-17,2,1,353000,74130,427130
354,2023-08-30,3,1,354000,74340,428340
355,2021-10-16,3,3,355000,74550,429550
356,2024-07-08,2,1,356000,74760,430760
357,2021-01-31,3,2,357000,74970,431970
358,2024-11-19,1,3,358000,75180,433180
359,2022-01-11,3,3,359000,75390,434390
360,2022-07-29,3,3,360000,75600,435600
361,2023-12-28,3,2,361000,75810,436810
362,2021-02-27,2,1,362000,76020,438020
363,2021-05-09,2,3,363000,76230,439230
364,2022-06-04,1,1,364000,76440,440440
365,2023-01-14,2,3,365000,76650,441650
366,2020-06-22,3,3,366000,76860,442860
367,2021-02-16,1,2,367000,77070,444070
368,2022-04-15,1,3,368000,77280,445280
369,2020-07-25,3,2,369000,77490,446490
370,2020-01-19,3,2,370000,77700,447700
371,2020-09-16,2,3,371000,77910,448910
372,2021-09-08,1,1,372000,78120,450120
373,2024-12-20,3,1,373000,78330,451330
374,2020-02-01,2,3,374000,78540,452540
375,2023-05-13,3,3,375000,78750,453750
376,2020-09-06,3,1,376000,78960,454960
377,2023-12-03,2,2,377000,79170,456170
378,2020-07-20,2,2,378000,79380,457380
379,2021-02-14,2,1,379000,79590,458590
380,2021-01-07,1,1,380000,79800,459800
381,2023-12-08,3,2,381000,80010,461010
382,2021-01-06,1,3,382000,80220,462220
383,2021-10-19,2,2,383000,80430,463430
384,2022-10-27,2,1,384000,80640,464640
385,2024-09-21,2,1,385000,80850,465850
386,2020-12-01,3,3,386000,81060,467060
387,2020-07-05,1,3,387000,81270,468270
388,2022-12-30,1,2,388000,81480,469480
389,2021-05-03,2,3,389000,81690,470690
390,2021-08-25,1,3,390000,81900,471900
391,2021-09-17,2,3,391000,82110,473110
392,2023-12-13,3,1,392000,82320,474320
393,2021-12-23,3,3,393000,82530,475530
394,2024-11-02,1,3,394000,82740,476740
395,2024-06-10,2,3,395000,82950,477950
396,2020-10-27,3,3,396000,83160,479160
397,2024-10-12,2,1,397000,83370,480370
398,2024-08-31,1,1,398000,83580,481580
399,2022-12-19,3,3,399000,83790,482790
400,2024-10-20,3,2,400000,84000,484000
401,2024-04-14,3,1,401000,84210,485210
402,2022-05-20,1,3,402000,84420,486420
403,2023-09-23,3,3,403000,84630,487630
404,2021-08-06,1,2,404000,84840,488840
405,2024-09-18,3,1,405000,85050,490050
406,2022-11-03,3,2,406000,85260,491260
407,2021-10-08,2,3,407000,85470,492470
408,2022-04-11,1,3,408000,85680,493680
409,2022-04-11,3,1,409000,85890,494890
410,2020-03-07,3,1,410000,86100,496100
411,2022-09-19,2,2,411000,86310,497310
412,2024-02-19,1,3,412000,86520,498520
413,2020-03-13,1,1,413000,86730,499730
414,2020-04-10,2,3,414000,86940,500940
415,2021-07-14,2,1,415000,87150,502150
416,2024-01-25,1,1,416000,87360,503360
417,2023-06-23,3,2,417000,87570,504570
418,2021-12-01,1,3,418000,87780,505780
419,2021-08-14,2,2,419000,87990,506990
420,2021-11-09,1,1,420000,88200,508200
421,2020-10-06,1,2,421000,88410,509410
422,2024-08-30,2,2,422000,88620,510620
423,2024-04-06,1,1,423000,88830,511830
424,2020-04-09,1,3,424000,89040,513040
425,2023-01-23,1,3,425000,89250,514250
426,2020-11-25,1,1,426000,89460,515460
427,2023-09-04,3,3,427000,89670,516670
428,2022-04-13,2,3,428000,89880,517880
429,2022-10-10,2,3,429000,90090,519090
430,2024-10-27,2,2,430000,90300,520300
431,2024-09-01,1,2,431000,90510,521510
432,2023-09-19,2,3,432000,90720,522720
433,2024-01-06,1,2,433000,90930,523930
434,2022-06-08,3,1,434000,91140,525140
435,2024-10-12,1,3,435000,91350,526350
436,2022-04-26,1,2,436000,91560,527560
437,2020-01-28,1,3,437000,91770,528770
438,2023-07-19,1,3,438000,91980,529980
439,2024-05-21,2,2,439000,92190,531190
440,2020-01-22,2,1,440000,92400,532400
441,2021-05-31,2,2,441000,92610,533610
442,2020-08-29,2,2,442000,92820,534820
443,2020-01-02,1,2,443000,93030,536030
444,2020-02-18,3,2,444000,93240,537240
445,2024-12-20,1,2,445000,93450,538450
446,2022-04-18,1,2,446000,93660,539660
447,2021-11-25,2,1,447000,93870,540870
448,2022-09-19,2,1,448000,94080,542080
449,2020-07-22,2,1,449000,94290,543290
450,2022-11-05,2,1,450000,94500,544500
451,2023-01-10,2,2,451000,94710,545710
452,2024-11-30,1,2,452000,94920,546920
453,2022-01-18,2,2,453000,95130,548130
454,2024-12-24,2,2,454000,95340,549340
455,2024-01-06,3,2,455000,95550,550550
456,2021-02-24,2,2,456000,95760,551760
457,2022-03-20,2,3,457000,95970,552970
458,2022-07-07,2,3,458000,96180,554180
459,2022-10-09,3,3,459000,96390,555390
460,2023-08-19,1,1,460000,96600,556600
461,2021-07-09,3,1,461000,96810,557810
462,2023-04-27,2,3,462000,97020,559020
463,2022-10-08,2,3,463000,97230,560230
464,2021-05-06,2,2,464000,97440,561440
465,2024-10-10,3,2,465000,97650,562650
466,2023-10-02,3,3,466000,97860,563860
467,2020-11-27,1,3,467000,98070,565070
468,2024-03-10,1,2,468000,98280,566280
469,2024-09-06,1,1,469000,98490,567490
470,2023-02-09,2,2,470000,98700,568700
471,2023-02-02,3,1,471000,98910,569910
472,2022-03-11,2,1,472000,99120,571120
473,2023-05-28,2,1,473000,99330,572330
474,2022-07-05,3,2,474000,99540,573540
475,2020-04-26,3,1,475000,99750,574750
476,2020-02-01,3,1,476000,99960,575960
477,2024-04-02,2,1,477000,100170,577170
478,2020-01-15,3,2,478000,100380,578380
479,2023-10-25,3,3,479000,100590,579590
480,2022-10-11,2,3,480000,100800,580800
481,2020-12-28,3,2,481000,101010,582010
482,2023-12-24,1,1,482000,101220,583220
483,2023-06-19,3,2,483000,101430,584430
484,2020-06-20,2,2,484000,101640,585640
485,2023-04-13,1,3,485000,101850,586850
486,2022-01-30,2,3,486000,102060,588060
487,2024-07-23,3,1,487000,102270,589270
488,2023-01-08,3,3,488000,102480,590480
489,2024-12-27,2,3,489000,102690,591690
490,2020-01-26,1,3,490000,102900,592900
491,2022-02-23,3,1,491000,103110,594110
492,2023-07-12,3,1,492000,103320,595320
493,2024-05-24,1,2,493000,103530,596530
494,2024-02-08,1,1,494000,103740,597740
495,2021-01-15,2,3,495000,103950,598950
496,2022-02-27,2,3,496000,104160,600160
497,2024-09-13,2,3,497000,104370,601370
498,2022-09-18,1,2,498000,104580,602580
499,2021-07-23,3,2,499000,104790,603790
500,2023-06-16,1,1,500000,105000,605000
501,2022-12-19,2,3,501000,105210,606210
502,2020-01-16,3,2,502000,105420,607420
503,2022-10-23,1,1,503000,105630,608630
504,2023-06-25,3,2,504000,105840,609840
505,2023-02-01,3,1,505000,106050,611050
506,2024-05-02,1,1,506000,106260,612260
507,2020-02-24,2,1,507000,106470,613470
508,2023-03-25,3,2,508000,106680,614680
509,2024-07-24,3,3,509000,106890,615890
510,2023-10-26,3,1,510000,107100,617100
511,2020-06-22,3,1,511000,107310,618310
512,2024-03-11,2,2,512000,107520,619520
513,2021-10-12,1,1,513000,107730,620730
514,2024-04-21,3,2,514000,107940,621940
515,2020-02-15,3,2,515000,108150,623150
516,2023-04-20,1,3,516000,108360,624360
517,2020-07-28,3,3,517000,108570,625570
518,2021-07-08,2,1,518000,108780,626780
519,2023-04-26,1,3,519000,108990,627990
520,2020-06-27,3,1,520000,109200,629200
521,2022-06-27,1,3,521000,109410,630410
522,2022-04-25,2,3,522000,109620,631620
523,2023-08-12,2,3,523000,109830,632830
524,2020-03-25,2,1,524000,110040,634040
525,2021-10-08,1,1,525000,110250,635250
526,2024-09-14,1,2,526000,110460,636460
527,2023-06-15,3,2,527000,110670,637670
528,2023-04-21,3,1,528000,110880,638880
529,2020-02-13,3,3,529000,111090,640090
530,2023-02-06,3,2,530000,111300,641300
531,2024-10-22,2,2,531000,111510,642510
532,2024-07-17,2,2,532000,111720,643720
533,2023-03-06,2,1,533000,111930,644930
534,2024-02-09,2,1,534000,112140,646140
535,2024-07-26,2,1,535000,112350,647350
536,2022-03-20,1,3,536000,112560,648560
537,2022-12-09,2,2,537000,112770,649770
538,2021-09-11,3,3,538000,112980,650980
539,2022-02-03,1,2,539000,113190,652190
540,2021-01-07,3,2,540000,113400,653400
541,2020-12-06,3,2,541000,113610,654610
542,2021-08-06,3,3,542000,113820,655820
543,2020-02-14,3,2,543000,114030,657030
544,2024-01-31,3,1,544000,114240,658240
545,2021-09-09,2,2,545000,114450,659450
546,2021-05-03,3,2,546000,114660,660660
547,2022-01-31,1,1,547000,114870,661870
548,2021-06-03,3,3,548000,115080,663080
549,2020-08-02,1,1,549000,115290,664290
550,2024-04-11,3,3,550000,115500,665500
551,2024-05-20,2,2,551000,115710,666710
552,2023-04-12,2,1,552000,115920,667920
553,2024-05-24,1,3,553000,116130,669130
554,2020-02-03,3,3,554000,116340,670340
555,2022-06-06,3,3,555000,116550,671550
556,2021-11-26,2,3,556000,116760,672760
557,2022-02-11,1,1,557000,116970,673970
558,2022-02-11,1,3,558000,117180,675180
559,2024-04-12,1,3,559000,117390,676390
560,2024-10-12,2,3,560000,117600,677600
561,2020-01-25,3,1,561000,117810,678810
562,2022-05-03,2,2,562000,118020,680020
563,2020-08-23,3,1,563000,118230,681230
564,2021-09-15,1,1,564000,118440,682440
565,2021-04-30,3,1,565000,118650,683650
566,2023-12-01,2,3,566000,118860,684860
567,2024-11-01,1,3,567000,119070,686070
568,2024-03-12,2,3,568000,119280,687280
569,2024-10-17,1,2,569000,119490,688490
570,2022-11-16,2,1,570000,119700,689700
571,2024-06-11,2,3,571000,119910,690910
572,2024-07-21,3,2,572000,120120,692120
573,2023-05-20,1,1,573000,120330,693330
574,2024-02-29,1,2,574000,120540,694540
575,2020-08-18,2,2,575000,120750,695750
576,2023-11-12,3,1,576000,120960,696960
577,2020-11-11,2,2,577000,121170,698170
578,2020-11-27,1,1,578000,121380,699380
579,2020-04-10,3,3,579000,121590,700590
580,2021-01-24,1,1,580000,121800,701800
581,2024-02-10,1,1,581000,122010,703010
582,2023-03-16,3,1,582000,122220,704220
583,2022-02-26,1,3,583000,122430,705430
584,2021-09-15,1,1,584000,122640,706640
585,2022-04-17,1,1,585000,122850,707850
586,2020-10-25,3,2,586000,123060,709060
587,2022-12-19,1,2,587000,123270,710270
588,2022-04-17,1,1,588000,123480,711480
589,2023-01-22,3,3,589000,123690,712690
590,2022-04-05,3,1,590000,123900,713900
591,2024-08-27,1,1,591000,124110,715110
592,2023-04-21,2,3,592000,124320,716320
593,2020-03-01,3,2,593000,124530,717530
594,2022-12-09,1,3,594000,124740,718740
595,2023-06-16,2,3,595000,124950,719950
596,2020-02-27,1,2,596000,125160,721160
597,2024-01-04,1,3,597000,125370,722370
598,2021-07-25,2,1,598000,125580,723580
599,2022-10-09,2,1,599000,125790,724790
600,2020-11-29,1,3,600000,126000,726000
601,2022-10-15,3,1,601000,126210,727210
602,2023-12-02,2,1,602000,126420,728420
603,2022-05-05,1,3,603000,126630,729630
604,2024-01-19,2,1,604000,126840,730840
605,2023-02-05,3,2,605000,127050,732050
606,2024-10-06,2,2,606000,127260,733260
607,2023-09-27,3,2,607000,127470,734470
608,2020-07-29,1,3,608000,127680,735680
609,2023-03-07,3,1,609000,127890,736890
610,2021-02-04,3,3,610000,128100,738100
611,2020-08-13,1,3,611000,128310,739310
612,2023-11-26,2,2,612000,128520,740520
613,2023-11-25,1,2,613000,128730,741730
614,2023-12-23,1,1,614000,128940,742940
615,2022-07-13,3,2,615000,129150,744150
616,2023-09-17,2,1,616000,129360,745360
617,2020-10-10,3,2,617000,129570,746570
618,2020-08-18,3,2,618000,129780,747780
619,2023-03-17,2,2,619000,129990,748990
620,2020-05-18,2,2,620000,130200,750200
621,2021-05-04,1,3,621000,130410,751410
622,2024-05-14,3,1,622000,130620,752620
623,2024-06-22,1,3,623000,130830,753830
624,2023-03-18,3,1,624000,131040,755040
625,2023-12-13,3,3,625000,131250,756250
626,2020-06-22,2,3,626000,131460,757460
627,2021-01-02,3,3,627000,131670,758670
628,2022-08-25,1,3,628000,131880,759880
629,2024-02-29,3,3,629000,132090,761090
630,2024-01-14,3,2,630000,132300,762300
631,2021-06-21,3,1,631000,132510,763510
632,2020-07-12,2,1,632000,132720,764720
633,2023-04-10,3,2,633000,132930,765930
634,2022-04-07,2,2,634000,133140,767140
635,2024-09-22,1,1,635000,133350,768350
636,2021-12-18,2,3,636000,133560,769560
637,2020-06-14,2,3,637000,133770,770770
638,2023-05-01,3,3,638000,133980,771980
639,2023-06-09,1,2,639000,134190,773190
640,2021-11-03,2,3,640000,134400,774400
641,2021-02-17,3,2,641000,134610,775610
642,2022-08-25,2,1,642000,134820,776820
643,2024-07-03,1,1,643000,135030,778030
644,2024-11-25,3,3,644000,135240,779240
645,2024-11-10,3,1,645000,135450,780450
646,2022-07-03,3,1,646000,135660,781660
647,2022-08-11,2,1,647000,135870,782870
648,2022-01-30,1,1,648000,136080,784080
649,2023-03-12,2,2,649000,136290,785290
650,2020-08-03,3,1,650000,136500,786500
651,2021-08-14,2,3,651000,136710,787710
652,2023-01-06,3,2,652000,136920,788920
653,2022-09-09,1,3,653000,137130,790130
654,2021-07-30,2,2,654000,137340,791340
655,2023-03-07,2,2,655000,137550,792550
656,2024-05-26,3,1,656000,137760,793760
657,2021-10-31,1,1,657000,137970,794970
658,2020-03-21,2,2,658000,138180,796180
659,2023-04-11,1,2,659000,138390,797390
660,2022-01-14,2,2,660000,138600,798600
661,2024-12-15,2,3,661000,138810,799810
662,2020-09-28,2,2,662000,139020,801020
663,2022-08-06,2,2,663000,139230,802230
664,2024-04-21,1,1,664000,139440,803440
665,2023-12-02,2,1,665000,139650,804650
666,2021-07-27,2,3,666000,139860,805860
667,2024-11-11,3,2,667000,140070,807070
668,2022-01-19,1,3,668000,140280,808280
669,2022-11-07,3,3,669000,140490,809490
670,2023-10-24,2,1,670000,140700,810700
671,2022-01-26,3,3,671000,140910,811910
672,2024-12-01,2,2,672000,141120,813120
673,2022-12-07,1,1,673000,141330,814330
674,2023-12-23,3,3,674000,141540,815540
675,2023-08-11,3,1,675000,141750,816750
676,2020-03-06,2,1,676000,141960,817960
677,2022-09-06,2,1,677000,142170,819170
678,2022-04-28,2,3,678000,142380,820380
679,2022-03-20,3,3,679000,142590,821590
680,2020-04-23,1,3,680000,142800,822800
681,2023-01-04,1,3,681000,143010,824010
682,2021-01-16,2,1,682000,143220,825220
683,2020-06-15,3,2,683000,143430,826430
684,2023-09-30,2,3,684000,143640,827640
685,2020-10-30,3,3,685000,143850,828850
686,2022-09-23,2,2,686000,144060,830060
687,2023-12-30,1,3,687000,144270,831270
688,2024-10-11,1,2,688000,144480,832480
689,2023-10-02,1,1,689000,144690,833690
690,2023-11-14,1,2,690000,144900,834900
691,2021-07-15,2,3,691000,145110,836110
692,2023-06-26,2,1,692000,145320,837320
693,2024-12-17,2,3,693000,145530,838530
694,2023-08-12,1,1,694000,145740,839740
695,2023-02-09,2,3,695000,145950,840950
696,2022-09-28,3,3,696000,146160,842160
697,2022-05-10,2,3,697000,146370,843370
698,2020-03-15,1,2,698000,146580,844580
699,2020-04-30,3,1,699000,146790,845790
700,2020-04-28,1,1,700000,147000,847000
701,2023-12-31,2,1,701000,147210,848210
702,2024-02-06,3,2,702000,147420,849420
703,2021-09-15,1,3,703000,147630,850630
704,2024-02-27,1,2,704000,147840,851840
705,2021-10-09,2,2,705000,148050,853050
706,2023-04-20,3,1,706000,148260,854260
707,2023-05-17,1,3,707000,148470,855470
708,2023-04-08,2,2,708000,148680,856680
709,2020-05-30,2,1,709000,148890,857890
710,2024-08-18,2,2,710000,149100,859100
711,2022-06-24,2,2,711000,149310,860310
712,2022-03-28,2,2,712000,149520,861520
713,2021-03-04,2,1,713000,149730,862730
714,2022-07-15,2,3,714000,149940,863940
715,2023-03-03,1,3,715000,150150,865150
716,2023-05-11,1,2,716000,150360,866360
717,2021-12-09,2,3,717000,150570,867570
718,2024-10-08,2,1,718000,150780,868780
719,2020-12-05,1,1,719000,150990,869990
720,2023-03-28,1,3,720000,151200,871200
721,2020-03-18,2,3,721000,151410,872410
722,2024-02-23,1,3,722000,151620,873620
723,2020-03-08,3,1,723000,151830,874830
724,2021-12-27,1,3,724000,152040,876040
725,2020-04-26,1,3,725000,152250,877250
726,2024-11-05,1,3,726000,152460,878460
727,2024-06-13,2,2,727000,152670,879670
728,2024-12-24,2,2,728000,152880,880880
729,2023-04-10,1,1,729000,153090,882090
730,2024-06-27,2,2,730000,153300,883300
731,2022-04-29,3,2,731000,153510,884510
732,2023-12-09,2,2,732000,153720,885720
733,2021-04-15,3,3,733000,153930,886930
734,2020-12-11,1,1,734000,154140,888140
735,2021-02-19,1,3,735000,154350,889350
736,2022-10-27,3,3,736000,154560,890560
737,2022-10-31,1,1,737000,154770,891770
738,2022-11-20,3,1,738000,154980,892980
739,2021-10-16,1,2,739000,155190,894190
740,2021-01-28,1,1,740000,155400,895400
741,2020-05-25,2,3,741000,155610,896610
742,2021-03-02,2,1,742000,155820,897820
743,2021-03-24,1,1,743000,156030,899030
744,2023-04-24,1,3,744000,156240,900240
745,2024-02-24,2,1,745000,156450,901450
746,2024-09-21,3,1,746000,156660,902660
747,2022-12-17,3,3,747000,156870,903870
748,2020-02-14,3,2,748000,157080,905080
749,2022-09-02,3,1,749000,157290,906290
750,2022-09-03,2,3,750000,157500,907500
751,2020-10-24,2,2,751000,157710,908710
752,2023-09-01,2,2,752000,157920,909920
753,2024-02-29,3,1,753000,158130,911130
754,2021-03-11,1,3,754000,158340,912340
755,2023-09-16,1,2,755000,158550,913550
756,2024-07-09,3,3,756000,158760,914760
757,2021-03-15,2,1,757000,158970,915970
758,2023-03-20,3,2,758000,159180,917180
759,2021-01-14,2,3,759000,159390,918390
760,2022-09-03,2,2,760000,159600,919600
761,2020-01-13,2,2,761000,159810,920810
762,2021-12-30,3,2,762000,160020,922020
763,2020-11-09,2,1,763000,160230,923230
764,2021-04-22,3,1,764000,160440,924440
765,2023-04-15,1,1,765000,160650,925650
766,2021-08-30,3,1,766000,160860,926860
767,2023-10-09,2,3,767000,161070,928070
768,2022-12-18,3,3,768000,161280,929280
769,2020-07-05,2,1,769000,161490,930490
770,2022-10-15,3,2,770000,161700,931700
771,2022-01-29,3,1,771000,161910,932910
772,2020-08-10,2,2,772000,162120,934120
773,2024-02-29,1,1,773000,162330,935330
774,2023-07-21,2,1,774000,162540,936540
775,2024-11-08,2,2,775000,162750,937750
776,2023-12-02,1,1,776000,162960,938960
777,2021-04-12,3,2,777000,163170,940170
778,2023-01-12,1,2,778000,163380,941380
779,2021-09-25,1,3,779000,163590,942590
780,2020-11-19,1,3,780000,163800,943800
781,2021-07-10,3,3,781000,164010,945010
782,2021-12-22,2,2,782000,164220,946220
783,2023-08-02,2,1,783000,164430,947430
784,2023-09-19,1,1,784000,164640,948640
785,2021-07-16,3,3,785000,164850,949850
786,2022-09-13,1,2,786000,165060,951060
787,2021-04-02,2,3,787000,165270,952270
788,2024-12-12,3,1,788000,165480,953480
789,2022-12-05,3,1,789000,165690,954690
790,2023-10-20,3,2,790000,165900,955900
791,2022-12-27,1,3,791000,166110,957110
792,2023-11-20,2,2,792000,166320,958320
793,2020-10-26,2,1,793000,166530,959530
794,2020-11-11,1,2,794000,166740,960740
795,2024-10-11,2,1,795000,166950,961950
796,2020-02-16,3,2,796000,167160,963160
797,2023-01-21,3,1,797000,167370,964370
798,2022-06-08,1,3,798000,167580,965580
799,2021-09-22,1,3,799000,167790,966790
800,2024-10-28,2,3,800000,168000,968000
801,2023-01-03,3,2,801000,168210,969210
802,2020-11-12,2,2,802000,168420,970420
803,2024-07-03,1,2,803000,168630,971630
804,2021-05-15,3,3,804000,168840,972840
805,2021-02-26,2,1,805000,169050,974050
806,2024-07-09,3,3,806000,169260,975260
807,2022-06-16,3,2,807000,169470,976470
808,2023-08-25,1,1,808000,169680,977680
809,2022-10-26,1,2,809000,169890,978890
810,2024-12-18,3,1,810000,170100,980100
811,2022-01-28,1,3,811000,170310,981310
812,2022-04-14,1,1,812000,170520,982520
813,2023-05-28,1,3,813000,170730,983730
814,2020-08-05,2,3,814000,170940,984940
815,2022-11-25,1,1,815000,171150,986150
816,2024-06-30,1,1,816000,171360,987360
817,2020-10-30,1,2,817000,171570,988570
818,2022-05-07,3,2,818000,171780,989780
819,2023-10-05,2,1,819000,171990,990990
820,2020-02-24,2,1,820000,172200,992200
821,2023-02-03,2,3,821000,172410,993410
822,2022-03-13,3,2,822000,172620,994620
823,2022-08-07,2,3,823000,172830,995830
824,2021-04-06,2,3,824000,173040,997040
825,2020-03-28,3,2,825000,173250,998250
826,2023-02-05,3,3,826000,173460,999460
827,2020-03-31,2,3,827000,173670,1000670
828,2022-05-10,2,1,828000,173880,1001880
829,2020-07-27,2,3,829000,174090,1003090
830,2020-10-23,2,3,830000,174300,1004300
831,2022-09-11,3,1,831000,174510,1005510
832,2021-01-09,3,2,832000,174720,1006720
833,2024-02-11,3,3,833000,174930,1007930
834,2023-05-23,3,1,834000,175140,1009140
835,2024-04-01,2,1,835000,175350,1010350
836,2021-11-05,2,2,836000,175560,1011560
837,2023-11-14,3,3,837000,175770,1012770
838,2024-04-12,3,3,838000,175980,1013980
839,2024-12-29,3,3,839000,176190,1015190
840,2021-02-27,2,2,840000,176400,1016400
841,2024-12-22,2,2,841000,176610,1017610
842,2024-06-21,3,2,842000,176820,1018820
843,2022-11-08,1,2,843000,177030,1020030
844,2024-06-27,2,1,844000,177240,1021240
845,2023-03-28,3,3,845000,177450,1022450
846,2024-10-22,2,1,846000,177660,1023660
847,2021-01-30,3,3,847000,177870,1024870
848,2024-09-20,3,1,848000,178080,1026080
849,2024-11-21,1,1,849000,178290,1027290
850,2024-03-30,3,3,850000,178500,1028500
851,2024-05-17,3,2,851000,178710,1029710
852,2021-12-04,1,2,852000,178920,1030920
853,2020-05-30,3,2,853000,179130,1032130
854,2021-02-25,1,2,854000,179340,1033340
855,2022-09-28,1,2,855000,179550,1034550
856,2021-05-16,2,3,856000,179760,1035760
857,2020-07-02,3,2,857000,179970,1036970
858,2022-06-05,1,3,858000,180180,1038180
859,2023-06-08,2,2,859000,180390,1039390
860,2022-07-08,2,3,860000,180600,1040600
861,2024-11-17,1,1,861000,180810,1041810
862,2022-12-09,1,1,862000,181020,1043020
863,2020-12-31,1,2,863000,181230,1044230
864,2022-12-04,3,1,864000,181440,1045440
865,2021-12-17,3,2,865000,181650,1046650
866,2024-06-23,3,2,866000,181860,1047860
867,2023-09-17,1,3,867000,182070,1049070
868,2023-04-30,3,1,868000,182280,1050280
869,2023-12-30,1,2,869000,182490,1051490
870,2021-04-29,3,2,870000,182700,1052700
871,2021-11-21,3,3,871000,182910,1053910
872,2021-03-24,3,3,872000,183120,1055120
873,2023-05-14,3,2,873000,183330,1056330
874,2024-07-10,1,2,874000,183540,1057540
875,2023-02-26,2,3,875000,183750,1058750
876,2022-11-02,1,2,876000,183960,1059960
877,2023-10-11,1,1,877000,184170,1061170
878,2021-11-12,3,1,878000,184380,1062380
879,2024-03-11,1,1,879000,184590,1063590
880,2020-01-19,2,3,880000,184800,1064800
881,2020-03-31,2,2,881000,185010,1066010
882,2021-10-05,1,3,882000,185220,1067220
883,2024-01-13,1,2,883000,185430,1068430
884,2023-04-18,1,2,884000,185640,1069640
885,2024-11-28,2,1,885000,185850,1070850
886,2020-08-18,1,2,886000,186060,1072060
887,2021-08-28,1,3,887000,186270,1073270
888,2021-12-06,2,1,888000,186480,1074480
889,2021-05-16,2,3,889000,186690,1075690
890,2020-09-23,2,3,890000,186900,1076900
891,2023-11-09,3,1,891000,187110,1078110
892,2024-03-19,3,3,892000,187320,1079320
893,2023-09-04,2,3,893000,187530,1080530
894,2021-03-13,2,3,894000,187740,1081740
895,2021-07-19,2,2,895000,187950,1082950
896,2021-10-20,2,3,896000,188160,1084160
897,2020-05-01,1,3,897000,188370,1085370
898,2021-02-06,2,2,898000,188580,1086580
899,2020-06-02,2,2,899000,188790,1087790
900,2020-09-02,3,2,900000,189000,1089000
901,2022-07-22,2,2,901000,189210,1090210
902,2024-05-03,2,3,902000,189420,1091420
903,2023-07-20,1,1,903000,189630,1092630
904,2024-08-24,2,2,904000,189840,1093840
905,2024-01-11,1,1,905000,190050,1095050
906,2024-12-05,2,1,906000,190260,1096260
907,2021-06-04,3,1,907000,190470,1097470
908,2020-05-24,2,2,908000,190680,1098680
909,2024-03-11,2,2,909000,190890,1099890
910,2021-12-05,1,3,910000,191100,1101100
911,2024-11-24,1,1,911000,191310,1102310
912,2022-01-31,2,2,912000,191520,1103520
913,2021-06-14,2,3,913000,191730,1104730
914,2022-04-01,3,2,914000,191940,1105940
915,2024-01-08,2,3,915000,192150,1107150
916,2020-12-27,1,2,916000,192360,1108360
917,2023-06-20,2,1,917000,192570,1109570
918,2024-06-28,1,2,918000,192780,1110780
919,2020-10-24,1,2,919000,192990,1111990
920,2021-12-30,3,1,920000,193200,1113200
921,2022-08-07,2,2,921000,193410,1114410
922,2020-06-05,1,2,922000,193620,1115620
923,2021-05-25,1,2,923000,193830,1116830
924,2023-07-16,2,2,924000,194040,1118040
925,2023-03-10,2,2,925000,194250,1119250
926,2021-08-12,3,2,926000,194460,1120460
927,2021-12-05,1,3,927000,194670,1121670
928,2020-11-17,2,3,928000,194880,1122880
929,2024-06-02,2,2,929000,195090,1124090
930,2023-09-03,3,3,930000,195300,1125300
931,2022-08-13,1,1,931000,195510,1126510
932,2023-12-21,3,1,932000,195720,1127720
933,2024-01-02,3,1,933000,195930,1128930
934,2021-05-19,3,3,934000,196140,1130140
935,2024-07-25,2,3,935000,196350,1131350
936,2023-03-11,2,1,936000,196560,1132560
937,2020-01-04,1,1,937000,196770,1133770
938,2021-11-07,1,3,938000,196980,1134980
939,2021-09-09,1,2,939000,197190,1136190
940,2022-10-30,1,1,940000,197400,1137400
941,2024-07-30,1,2,941000,197610,1138610
942,2022-12-08,3,2,942000,197820,1139820
943,2021-03-16,2,2,943000,198030,1141030
944,2021-03-13,3,3,944000,198240,1142240
945,2022-07-26,1,2,945000,198450,1143450
946,2021-03-24,3,3,946000,198660,1144660
947,2023-07-01,2,1,947000,198870,1145870
948,2023-06-23,3,2,948000,199080,1147080
949,2024-05-22,1,3,949000,199290,1148290
950,2022-11-12,3,2,950000,199500,1149500
951,2022-02-02,2,2,951000,199710,1150710
952,2024-06-20,1,2,952000,199920,1151920
953,2020-10-10,2,2,953000,200130,1153130
954,2024-05-22,3,2,954000,200340,1154340
955,2024-04-23,1,1,955000,200550,1155550
956,2023-11-21,3,2,956000,200760,1156760
957,2021-12-29,1,1,957000,200970,1157970
958,2021-01-09,3,2,958000,201180,1159180
959,2023-05-19,3,3,959000,201390,1160390
960,2024-06-02,3,3,960000,201600,1161600
961,2024-01-27,2,1,961000,201810,1162810
962,2024-04-07,3,3,962000,202020,1164020
963,2020-12-11,3,1,963000,202230,1165230
964,2021-02-09,1,3,964000,202440,1166440
965,2022-06-28,1,3,965000,202650,1167650
966,2021-09-07,3,3,966000,202860,1168860
967,2020-07-01,2,1,967000,203070,1170070
968,2024-07-04,2,2,968000,203280,1171280
969,2022-06-12,2,2,969000,203490,1172490
970,2022-10-27,2,2,970000,203700,1173700
971,2022-06-17,3,3,971000,203910,1174910
972,2024-08-12,2,3,972000,204120,1176120
973,2021-08-19,1,3,973000,204330,1177330
974,2020-11-05,3,1,974000,204540,1178540
975,2022-09-02,1,2,975000,204750,1179750
976,2020-07-08,3,1,976000,204960,1180960
977,2024-07-28,3,1,977000,205170,1182170
978,2023-04-23,1,1,978000,205380,1183380
979,2023-09-27,2,2,979000,205590,1184590
980,2020-09-25,2,2,980000,205800,1185800
981,2020-05-23,2,1,981000,206010,1187010
982,2020-11-13,3,3,982000,206220,1188220
983,2020-03-23,3,1,983000,206430,1189430
984,2023-06-28,2,1,984000,206640,1190640
985,2021-10-25,3,1,985000,206850,1191850
986,2021-11-02,1,1,986000,207060,1193060
987,2024-02-15,2,2,987000,207270,1194270
988,2023-02-15,2,3,988000,207480,1195480
989,2020-01-13,1,3,989000,207690,1196690
990,2021-04-29,3,2,990000,207900,1197900
991,2024-02-25,2,3,991000,208110,1199110
992,2024-01-23,2,3,992000,208320,1200320
993,2020-12-29,1,1,993000,208530,1201530
994,2022-09-23,3,2,994000,208740,1202740
995,2022-01-30,3,3,995000,208950,1203950
996,2024-05-14,2,2,996000,209160,1205160
997,2021-03-02,1,2,997000,209370,1206370
998,2022-03-10,2,3,998000,209580,1207580
999,2020-05-08,1,1,999000,209790,1208790
1000,2024-11-21,1,1,1000000,210000,1210000
1001,2021-06-08,1,1,1001000,210210,1211210
1002,2020-10-19,3,3,1002000,210420,1212420
1003,2023-06-19,2,3,1003000,210630,1213630
1004,2020-06-18,2,2,1004000,210840,1214840
1005,2024-07-31,3,1,1005000,211050,1216050
1006,2021-11-05,2,3,1006000,211260,1217260
1007,2020-02-13,3,3,1007000,211470,1218470
1008,2023-12-16,1,3,1008000,211680,1219680
1009,2021-04-28,2,3,1009000,211890,1220890
1010,2023-05-08,1,3,1010000,212100,1222100
1011,2021-01-20,1,3,1011000,212310,1223310
1012,2021-09-24,1,1,1012000,212520,1224520
1013,2022-03-07,2,3,1013000,212730,1225730
1014,2020-07-07,3,2,1014000,212940,1226940
1015,2021-02-21,3,3,1015000,213150,1228150
1016,2024-02-01,1,1,1016000,213360,1229360
1017,2022-07-13,2,1,1017000,213570,1230570
1018,2020-02-23,2,3,1018000,213780,1231780
1019,2023-06-26,3,1,1019000,213990,1232990
1020,2022-04-07,2,1,1020000,214200,1234200
1021,2024-03-20,1,1,1021000,214410,1235410
1022,2021-08-04,1,1,1022000,214620,1236620
1023,2023-10-27,3,1,1023000,214830,1237830
1024,2022-11-02,1,2,1024000,215040,1239040
1025,2020-02-29,3,2,1025000,215250,1240250
1026,2021-08-03,1,3,1026000,215460,1241460
1027,2021-07-19,3,2,1027000,215670,1242670
1028,2020-09-02,3,1,1028000,215880,1243880
1029,2022-04-13,2,3,1029000,216090,1245090
1030,2024-05-08,2,3,1030000,216300,1246300
1031,2024-11-14,2,1,1031000,216510,1247510
1032,2020-06-17,3,1,1032000,216720,1248720
1033,2020-07-23,1,3,1033000,216930,1249930
1034,2021-05-13,2,3,1034000,217140,1251140
1035,2021-11-01,1,3,1035000,217350,1252350
1036,2022-06-12,1,1,1036000,217560,1253560
1037,2021-05-18,2,3,1037000,217770,1254770
1038,2022-06-12,1,1,1038000,217980,1255980
1039,2020-09-14,3,2,1039000,218190,1257190
1040,2021-01-28,3,1,1040000,218400,1258400
1041,2022-08-05,1,1,1041000,218610,1259610
1042,2024-01-21,2,3,1042000,218820,1260820
1043,2021-12-23,1,2,1043000,219030,1262030
1044,2020-11-09,1,1,1044000,219240,1263240
1045,2023-10-20,1,2,1045000,219450,1264450
1046,2024-04-15,2,3,1046000,219660,1265660
1047,2020-03-08,1,3,1047000,219870,1266870
1048,2023-09-24,1,1,1048000,220080,1268080
1049,2024-11-22,2,1,1049000,220290,1269290
1050,2024-06-15,3,1,1050000,220500,1270500
1051,2023-06-05,3,3,1051000,220710,1271710
1052,2021-08-26,1,3,1052000,220920,1272920
1053,2022-07-17,2,1,1053000,221130,1274130
1054,2020-10-22,3,2,1054000,221340,1275340
1055,2021-04-17,1,3,1055000,221550,1276550
1056,2020-01-08,2,1,1056000,221760,1277760
1057,2020-09-27,3,3,1057000,221970,1278970
1058,2024-12-12,3,1,1058000,222180,1280180
1059,2020-12-29,1,2,1059000,222390,1281390
1060,2022-04-11,2,2,1060000,222600,1282600
1061,2023-04-29,3,1,1061000,222810,1283810
1062,2023-10-27,3,2,1062000,223020,1285020
1063,2020-07-27,1,3,1063000,223230,1286230
1064,2021-07-16,1,1,1064000,223440,1287440
1065,2024-08-26,2,3,1065000,223650,1288650
1066,2024-08-26,1,1,1066000,223860,1289860
1067,2022-02-16,2,1,1067000,224070,1291070
1068,2020-03-03,3,2,1068000,224280,1292280
1069,2022-12-04,1,1,1069000,224490,1293490
1070,2022-05-28,2,2,1070000,224700,1294700
1071,2024-03-08,2,2,1071000,224910,1295910
1072,2024-02-18,1,2,1072000,225120,1297120
1073,2020-05-19,3,1,1073000,225330,1298330
1074,2022-03-29,1,2,1074000,225540,1299540
1075,2023-01-15,3,1,1075000,225750,1300750
1076,2023-10-24,1,1,1076000,225960,1301960
1077,2023-04-11,2,3,1077000,226170,1303170
1078,2020-05-20,1,3,1078000,226380,1304380
1079,2020-02-01,2,2,1079000,226590,1305590
1080,2023-09-13,1,2,1080000,226800,1306800
1081,2022-12-10,2,3,1081000,227010,1308010
1082,2021-08-21,2,3,1082000,227220,1309220
1083,2020-04-15,2,3,1083000,227430,1310430
1084,2023-05-02,3,2,1084000,227640,1311640
1085,2021-01-01,3,2,1085000,227850,1312850
1086,2023-11-23,2,1,1086000,228060,1314060
1087,2023-01-12,1,3,1087000,228270,1315270
1088,2020-09-12,2,2,1088000,228480,1316480
1089,2023-08-16,2,1,1089000,228690,1317690
1090,2024-07-20,2,1,1090000,228900,1318900
1091,2023-12-10,2,1,1091000,229110,1320110
1092,2022-01-18,2,2,1092000,229320,1321320
1093,2023-01-23,3,3,1093000,229530,1322530
1094,2020-02-14,3,1,1094000,229740,1323740
1095,2020-01-06,3,3,1095000,229950,1324950
1096,2021-05-25,3,2,1096000,230160,1326160
1097,2023-06-02,3,2,1097000,230370,1327370
1098,2022-06-22,3,1,1098000,230580,1328580
1099,2024-04-06,3,3,1099000,230790,1329790
1100,2024-01-17,2,2,1100000,231000,1331000
1101,2022-11-16,1,1,1101000,231210,1332210
1102,2020-09-21,2,2,1102000,231420,1333420
1103,2024-02-18,1,2,1103000,231630,1334630
1104,2024-01-06,2,1,1104000,231840,1335840
1105,2021-09-25,2,2,1105000,232050,1337050
1106,2021-12-20,3,2,1106000,232260,1338260
1107,2024-05-05,1,2,1107000,232470,1339470
1108,2021-08-03,3,2,1108000,232680,1340680
1109,2022-11-22,3,1,1109000,232890,1341890
1110,2022-05-19,2,1,1110000,233100,1343100
1111,2020-05-25,3,3,1111000,233310,1344310
1112,2024-04-01,2,3,1112000,233520,1345520
1113,2021-07-02,3,1,1113000,233730,1346730
1114,2022-05-21,2,2,1114000,233940,1347940
1115,2021-11-24,3,2,1115000,234150,1349150
1116,2020-07-10,2,2,1116000,234360,1350360
1117,2023-09-09,2,2,1117000,234570,1351570
1118,2020-12-14,3,3,1118000,234780,1352780
1119,2024-09-17,1,1,1119000,234990,1353990
1120,2022-05-02,1,3,1120000,235200,1355200
1121,2021-05-13,1,3,1121000,235410,1356410
1122,2023-11-09,2,2,1122000,235620,1357620
1123,2020-11-16,1,1,1123000,235830,1358830
1124,2023-11-01,2,1,1124000,236040,1360040
1125,2020-08-29,2,3,1125000,236250,1361250
1126,2023-09-28,2,2,1126000,236460,1362460
1127,2023-09-05,1,3,1127000,236670,1363670
1128,2024-02-29,3,3,1128000,236880,1364880
1129,2021-05-24,2,1,1129000,237090,1366090
1130,2020-01-05,1,3,1130000,237300,1367300
1131,2020-08-26,3,2,1131000,237510,1368510
1132,2020-08-03,2,2,1132000,237720,1369720
1133,2023-03-16,3,2,1133000,237930,1370930
1134,2020-10-22,2,2,1134000,238140,1372140
1135,2020-02-26,1,3,1135000,238350,1373350
1136,2020-06-04,3,2,1136000,238560,1374560
1137,2020-11-30,2,1,1137000,238770,1375770
1138,2024-12-17,2,2,1138000,238980,1376980
1139,2022-11-16,2,2,1139000,239190,1378190
1140,2023-02-18,1,1,1140000,239400,1379400
1141,2023-02-05,2,2,1141000,239610,1380610
1142,2024-07-29,3,1,1142000,239820,1381820
1143,2023-11-04,2,1,1143000,240030,1383030
1144,2023-10-16,1,1,1144000,240240,1384240
1145,2023-03-01,1,2,1145000,240450,1385450
1146,2023-10-15,3,1,1146000,240660,1386660
1147,2022-11-25,3,1,1147000,240870,1387870
1148,2020-10-08,1,1,1148000,241080,1389080
1149,2023-07-29,1,2,1149000,241290,1390290
1150,2021-04-13,1,2,1150000,241500,1391500
1151,2022-10-04,3,1,1151000,241710,1392710
1152,2021-02-10,3,2,1152000,241920,1393920
1153,2022-12-23,1,1,1153000,242130,1395130
1154,2023-01-03,2,2,1154000,242340,1396340
1155,2020-08-28,2,3,1155000,242550,1397550
1156,2021-10-20,2,3,1156000,242760,1398760
1157,2024-08-24,3,2,1157000,242970,1399970
1158,2024-09-27,1,3,1158000,243180,1401180
1159,2022-11-01,2,2,1159000,243390,1402390
1160,2022-03-26,3,3,1160000,243600,1403600
1161,2020-08-02,2,1,1161000,243810,1404810
1162,2024-01-17,2,2,1162000,244020,1406020
1163,2020-07-06,2,2,1163000,244230,1407230
1164,2022-12-14,3,3,1164000,244440,1408440
1165,2021-02-09,2,2,1165000,244650,1409650
1166,2022-12-27,1,1,1166000,244860,1410860
1167,2023-11-17,2,1,1167000,245070,1412070
1168,2022-06-15,3,2,1168000,245280,1413280
1169,2022-08-18,2,1,1169000,245490,1414490
1170,2023-04-09,1,2,1170000,245700,1415700
1171,2020-03-06,2,2,1171000,245910,1416910
1172,2024-09-30,2,2,1172000,246120,1418120
1173,2022-04-15,1,2,1173000,246330,1419330
1174,2023-10-27,3,3,1174000,246540,1420540
1175,2023-06-07,3,3,1175000,246750,1421750
1176,2024-05-06,2,1,1176000,246960,1422960
1177,2020-09-13,2,2,1177000,247170,1424170
1178,2024-09-04,3,3,1178000,247380,1425380
1179,2024-11-02,1,2,1179000,247590,1426590
1180,2022-06-04,2,1,1180000,247800,1427800
1181,2023-07-22,2,3,1181000,248010,1429010
1182,2021-12-13,3,1,1182000,248220,1430220
1183,2022-10-13,3,3,1183000,248430,1431430
1184,2021-08-04,3,2,1184000,248640,1432640
1185,2020-08-29,1,1,1185000,248850,1433850
1186,2024-10-12,1,1,1186000,249060,1435060
1187,2022-05-08,3,1,1187000,249270,1436270
1188,2022-06-07,1,1,1188000,249480,1437480
1189,2024-01-15,2,3,1189000,249690,1438690
1190,2023-04-10,1,1,1190000,249900,1439900
1191,2022-07-22,3,1,1191000,250110,1441110
1192,2022-07-12,1,3,1192000,250320,1442320
1193,2023-05-04,3,1,1193000,250530,1443530
1194,2023-07-03,1,1,1194000,250740,1444740
1195,2020-03-15,2,3,1195000,250950,1445950
1196,2020-05-17,2,1,1196000,251160,1447160
1197,2023-02-25,3,2,1197000,251370,1448370
1198,2022-02-08,3,2,1198000,251580,1449580
1199,2023-05-19,3,3,1199000,251790,1450790
1200,2023-11-15,3,2,1200000,252000,1452000
1201,2020-06-23,3,1,1201000,252210,1453210
1202,2020-11-18,1,2,1202000,252420,1454420
1203,2020-07-08,3,1,1203000,252630,1455630
1204,2020-08-06,2,3,1204000,252840,1456840
1205,2022-09-02,1,3,1205000,253050,1458050
1206,2024-04-15,3,1,1206000,253260,1459260
1207,2021-10-01,1,3,1207000,253470,1460470
1208,2023-07-21,1,1,1208000,253680,1461680
1209,2023-07-16,2,2,1209000,253890,1462890
1210,2023-02-26,3,2,1210000,254100,1464100
1211,2021-12-15,3,2,1211000,254310,1465310
1212,2020-03-24,2,2,1212000,254520,1466520
1213,2020-01-13,1,2,1213000,254730,1467730
1214,2023-02-12,1,1,1214000,254940,1468940
1215,2021-09-05,3,3,1215000,255150,1470150
1216,2020-08-25,1,3,1216000,255360,1471360
1217,2020-01-03,2,3,1217000,255570,1472570
1218,2024-07-18,2,3,1218000,255780,1473780
1219,2021-06-09,2,3,1219000,255990,1474990
1220,2024-04-20,2,2,1220000,256200,1476200
1221,2023-01-12,2,3,1221000,256410,1477410
1222,2021-05-17,3,1,1222000,256620,1478620
1223,2021-04-08,3,3,1223000,256830,1479830
1224,2020-12-30,2,2,1224000,257040,1481040
1225,2024-03-08,3,2,1225000,257250,1482250
1226,2022-12-11,2,3,1226000,257460,1483460
1227,2020-06-27,3,1,1227000,257670,1484670
1228,2023-03-06,3,2,1228000,257880,1485880
1229,2020-08-15,3,3,1229000,258090,1487090
1230,2021-11-06,3,3,1230000,258300,1488300
1231,2021-06-04,2,2,1231000,258510,1489510
1232,2021-12-18,3,2,1232000,258720,1490720
1233,2020-02-04,1,3,1233000,258930,1491930
1234,2020-10-24,1,3,1234000,259140,1493140
1235,2021-05-23,3,2,1235000,259350,1494350
1236,2023-10-30,1,1,1236000,259560,1495560
1237,2022-01-08,1,1,1237000,259770,1496770
1238,2024-06-27,1,1,1238000,259980,1497980
1239,2021-05-25,2,3,1239000,260190,1499190
1240,2023-08-27,1,1,1240000,260400,1500400
1241,2020-08-08,3,3,1241000,260610,1501610
1242,2021-11-29,3,3,1242000,260820,1502820
1243,2021-12-07,2,1,1243000,261030,1504030
1244,2024-04-30,2,3,1244000,261240,1505240
1245,2021-11-10,1,2,1245000,261450,1506450
1246,2024-05-11,2,3,1246000,261660,1507660
1247,2022-06-09,1,3,1247000,261870,1508870
1248,2023-11-07,1,1,1248000,262080,1510080
1249,2022-09-29,2,1,1249000,262290,1511290
1250,2022-11-14,1,3,1250000,262500,1512500
1251,2022-11-20,1,1,1251000,262710,1513710
1252,2020-11-18,3,2,1252000,262920,1514920
1253,2024-10-14,3,3,1253000,263130,1516130
1254,2020-07-22,1,1,1254000,263340,1517340
1255,2021-09-19,3,2,1255000,263550,1518550
1256,2022-12-26,2,2,1256000,263760,1519760
1257,2020-05-13,3,2,1257000,263970,1520970
1258,2022-12-07,3,2,1258000,264180,1522180
1259,2024-09-15,1,3,1259000,264390,1523390
1260,2020-06-01,1,3,1260000,264600,1524600
1261,2022-02-16,3,2,1261000,264810,1525810
1262,2023-12-18,2,3,1262000,265020,1527020
1263,2024-11-26,3,1,1263000,265230,1528230
1264,2020-03-19,1,1,1264000,265440,1529440
1265,2024-04-25,1,3,1265000,265650,1530650
1266,2020-07-02,3,3,1266000,265860,1531860
1267,2021-02-21,1,3,1267000,266070,1533070
1268,2020-02-13,1,2,1268000,266280,1534280
1269,2024-08-18,3,3,1269000,266490,1535490
1270,2022-06-28,3,2,1270000,266700,1536700
1271,2021-03-21,1,2,1271000,266910,1537910
1272,2024-06-03,1,3,1272000,267120,1539120
1273,2021-02-18,1,3,1273000,267330,1540330
1274,2023-06-03,2,3,1274000,267540,1541540
1275,2022-07-15,2,1,1275000,267750,1542750
1276,2022-11-10,3,2,1276000,267960,1543960
1277,2020-01-28,2,3,1277000,268170,1545170
1278,2022-01-30,3,3,1278000,268380,1546380
1279,2024-09-21,1,1,1279000,268590,1547590
1280,2024-01-24,3,1,1280000,268800,1548800
1281,2023-03-09,3,1,1281000,269010,1550010
1282,2021-03-01,1,3,1282000,269220,1551220
1283,2022-10-06,2,2,1283000,269430,1552430
1284,2022-07-30,2,1,1284000,269640,1553640
1285,2024-07-01,3,1,1285000,269850,1554850
1286,2023-09-03,3,1,1286000,270060,1556060
1287,2022-05-09,3,3,1287000,270270,1557270
1288,2022-04-17,1,3,1288000,270480,1558480
1289,2021-06-17,1,1,1289000,270690,1559690
1290,2023-01-28,2,3,1290000,270900,1560900
1291,2021-10-31,1,3,1291000,271110,1562110
1292,2021-07-02,2,1,1292000,271320,1563320
1293,2024-10-19,1,1,1293000,271530,1564530
1294,2021-11-29,2,2,1294000,271740,1565740
1295,2020-11-09,1,3,1295000,271950,1566950
1296,2021-07-03,3,2,1296000,272160,1568160
1297,2021-08-09,1,2,1297000,272370,1569370
1298,2024-12-29,2,2,1298000,272580,1570580
1299,2024-04-19,1,3,1299000,272790,1571790
1300,2023-01-25,2,3,1300000,273000,1573000
1301,2024-08-17,2,3,1301000,273210,1574210
1302,2023-08-07,3,1,1302000,273420,1575420
1303,2023-11-27,3,3,1303000,273630,1576630
1304,2020-07-23,3,2,1304000,273840,1577840
1305,2021-02-05,2,3,1305000,274050,1579050
1306,2021-12-07,1,1,1306000,274260,1580260
1307,2023-12-11,1,2,1307000,274470,1581470
1308,2021-04-10,3,2,1308000,274680,1582680
1309,2021-03-08,1,1,1309000,274890,1583890
1310,2021-05-17,1,3,1310000,275100,1585100
1311,2020-11-01,3,3,1311000,275310,1586310
1312,2021-03-15,3,3,1312000,275520,1587520
1313,2023-02-11,1,3,1313000,275730,1588730
1314,2021-01-12,2,2,1314000,275940,1589940
1315,2020-04-16,3,1,1315000,276150,1591150
1316,2021-09-05,3,2,1316000,276360,1592360
1317,2023-05-07,1,3,1317000,276570,1593570
1318,2021-01-15,1,2,1318000,276780,1594780
1319,2023-12-18,2,2,1319000,276990,1595990
1320,2024-04-13,1,1,1320000,277200,1597200
1321,2021-11-20,3,1,1321000,277410,1598410
1322,2020-07-06,2,3,1322000,277620,1599620
1323,2023-05-02,1,2,1323000,277830,1600830
1324,2020-04-05,2,1,1324000,278040,1602040
1325,2021-05-08,3,3,1325000,278250,1603250
1326,2021-12-30,1,3,1326000,278460,1604460
1327,2020-03-16,3,2,1327000,278670,1605670
1328,2021-04-17,2,3,1328000,278880,1606880
1329,2020-07-04,2,2,1329000,279090,1608090
1330,2024-07-12,3,3,1330000,279300,1609300
1331,2023-05-30,1,3,1331000,279510,1610510
1332,2022-12-07,3,3,1332000,279720,1611720
1333,2024-07-24,3,2,1333000,279930,1612930
1334,2020-11-30,1,1,1334000,280140,1614140
1335,2020-07-06,1,2,1335000,280350,1615350
1336,2022-01-27,1,2,1336000,280560,1616560
1337,2023-11-15,3,3,1337000,280770,1617770
1338,2021-09-28,3,2,1338000,280980,1618980
1339,2020-06-03,1,3,1339000,281190,1620190
1340,2022-05-15,3,3,1340000,281400,1621400
1341,2024-04-15,3,3,1341000,281610,1622610
1342,2020-09-02,2,2,1342000,281820,1623820
1343,2020-08-08,3,2,1343000,282030,1625030
1344,2021-04-26,2,3,1344000,282240,1626240
1345,2024-05-02,1,3,1345000,282450,1627450
1346,2024-09-26,1,3,1346000,282660,1628660
1347,2020-09-22,2,1,1347000,282870,1629870
1348,2023-02-16,3,2,1348000,283080,1631080
1349,2022-07-16,2,1,1349000,283290,1632290
1350,2023-09-02,1,1,1350000,283500,1633500
1351,2022-11-09,1,3,1351000,283710,1634710
1352,2020-07-09,1,1,1352000,283920,1635920
1353,2023-01-07,2,2,1353000,284130,1637130
1354,2022-07-05,3,3,1354000,284340,1638340
1355,2024-08-17,1,2,1355000,284550,1639550
1356,2022-04-08,3,2,1356000,284760,1640760
1357,2020-01-01,3,1,1357000,284970,1641970
1358,2023-05-31,3,3,1358000,285180,1643180
1359,2022-11-21,1,1,1359000,285390,1644390
1360,2022-02-11,2,3,1360000,285600,1645600
1361,2022-10-19,2,2,1361000,285810,1646810
1362,2021-03-08,3,2,1362000,286020,1648020
1363,2023-10-07,3,3,1363000,286230,1649230
1364,2020-05-09,2,2,1364000,286440,1650440
1365,2022-05-01,3,1,1365000,286650,1651650
1366,2021-10-16,2,3,1366000,286860,1652860
1367,2021-10-24,1,1,1367000,287070,1654070
1368,2021-04-05,1,3,1368000,287280,1655280
1369,2021-03-19,2,1,1369000,287490,1656490
1370,2020-07-06,2,2,1370000,287700,1657700
1371,2022-08-10,2,3,1371000,287910,1658910
1372,2022-01-03,1,2,1372000,288120,1660120
1373,2021-05-12,3,2,1373000,288330,1661330
1374,2020-08-11,1,3,1374000,288540,1662540
1375,2023-06-30,1,3,1375000,288750,1663750
1376,2021-02-27,3,3,1376000,288960,1664960
1377,2023-11-13,1,1,1377000,289170,1666170
1378,2023-01-11,3,2,1378000,289380,1667380
1379,2021-04-14,2,3,1379000,289590,1668590
1380,2021-03-14,3,1,1380000,289800,1669800
1381,2022-11-22,3,3,1381000,290010,1671010
1382,2021-02-04,1,2,1382000,290220,1672220
1383,2021-01-11,3,1,1383000,290430,1673430
1384,2021-02-14,3,2,1384000,290640,1674640
1385,2022-01-18,3,3,1385000,290850,1675850
1386,2022-06-20,2,3,1386000,291060,1677060
1387,2023-07-23,1,1,1387000,291270,1678270
1388,2021-11-28,1,1,1388000,291480,1679480
1389,2024-09-01,1,3,1389000,291690,1680690
1390,2020-03-09,3,1,1390000,291900,1681900
1391,2020-08-03,1,2,1391000,292110,1683110
1392,2022-03-11,3,1,1392000,292320,1684320
1393,2024-05-18,2,1,1393000,292530,1685530
1394,2021-06-09,2,1,1394000,292740,1686740
1395,2024-07-12,1,2,1395000,292950,1687950
1396,2020-06-26,2,1,1396000,293160,1689160
1397,2020-11-18,1,3,1397000,293370,1690370
1398,2022-09-01,1,2,1398000,293580,1691580
1399,2024-07-22,1,1,1399000,293790,1692790
1400,2021-06-08,1,2,1400000,294000,1694000
1401,2021-08-16,3,1,1401000,294210,1695210
1402,2021-01-21,1,3,1402000,294420,1696420
1403,2021-12-28,1,1,1403000,294630,1697630
1404,2021-02-16,3,3,1404000,294840,1698840
1405,2023-02-01,2,3,1405000,295050,1700050
1406,2022-06-08,2,3,1406000,295260,1701260
1407,2023-05-05,1,2,1407000,295470,1702470
1408,2023-10-02,1,1,1408000,295680,1703680
1409,2024-03-17,3,2,1409000,295890,1704890
1410,2024-08-25,3,1,1410000,296100,1706100
1411,2022-11-22,2,1,1411000,296310,1707310
1412,2023-10-29,3,2,1412000,296520,1708520
1413,2021-06-17,1,1,1413000,296730,1709730
1414,2021-10-19,3,2,1414000,296940,1710940
1415,2023-09-10,3,3,1415000,297150,1712150
1416,2023-10-17,2,2,1416000,297360,1713360
1417,2020-05-25,2,1,1417000,297570,1714570
1418,2022-11-21,3,2,1418000,297780,1715780
1419,2021-05-06,2,3,1419000,297990,1716990
1420,2024-11-08,2,1,1420000,298200,1718200
1421,2023-08-29,3,3,1421000,298410,1719410
1422,2024-01-01,3,1,1422000,298620,1720620
1423,2023-09-02,3,1,1423000,298830,1721830
1424,2020-03-16,3,3,1424000,299040,1723040
1425,2021-06-22,1,1,1425000,299250,1724250
1426,2020-12-24,1,3,1426000,299460,1725460
1427,2024-11-05,1,1,1427000,299670,1726670
1428,2024-07-03,1,3,1428000,299880,1727880
1429,2024-03-13,1,2,1429000,300090,1729090
1430,2021-06-08,3,1,1430000,300300,1730300
1431,2024-04-27,2,1,1431000,300510,1731510
1432,2022-02-10,1,2,1432000,300720,1732720
1433,2023-07-13,1,3,1433000,300930,1733930
1434,2020-09-29,3,2,1434000,301140,1735140
1435,2024-02-06,3,2,1435000,301350,1736350
1436,2023-11-14,1,2,1436000,301560,1737560
1437,2020-11-08,1,3,1437000,301770,1738770
1438,2020-12-10,2,3,1438000,301980,1739980
1439,2020-06-19,1,3,1439000,302190,1741190
1440,2024-08-27,1,2,1440000,302400,1742400
1441,2023-10-05,3,3,1441000,302610,1743610
1442,2023-08-01,2,1,1442000,302820,1744820
1443,2023-05-09,3,2,1443000,303030,1746030
1444,2021-12-31,1,2,1444000,303240,1747240
1445,2020-11-14,3,2,1445000,303450,1748450
1446,2023-11-28,1,2,1446000,303660,1749660
1447,2021-01-30,1,2,1447000,303870,1750870
1448,2023-11-11,1,3,1448000,304080,1752080
1449,2020-01-23,3,2,1449000,304290,1753290
1450,2023-08-25,2,1,1450000,304500,1754500
1451,2024-12-21,3,3,1451000,304710,1755710
1452,2021-03-29,1,2,1452000,304920,1756920
1453,2024-04-20,3,3,1453000,305130,1758130
1454,2021-12-14,2,3,1454000,305340,1759340
1455,2024-11-13,3,2,1455000,305550,1760550
1456,2020-03-20,3,3,1456000,305760,1761760
1457,2020-12-18,3,2,1457000,305970,1762970
1458,2022-10-08,3,3,1458000,306180,1764180
1459,2023-06-13,1,1,1459000,306390,1765390
1460,2023-06-08,2,3,1460000,306600,1766600
1461,2024-11-20,3,2,1461000,306810,1767810
1462,2021-03-12,1,2,1462000,307020,1769020
1463,2023-09-23,3,2,1463000,307230,1770230
1464,2022-08-21,1,3,1464000,307440,1771440
1465,2022-12-13,2,2,1465000,307650,1772650
1466,2020-04-03,2,2,1466000,307860,1773860
1467,2020-04-27,1,1,1467000,308070,1775070
1468,2024-05-01,1,2,1468000,308280,1776280
1469,2022-11-06,3,1,1469000,308490,1777490
1470,2023-10-29,1,2,1470000,308700,1778700
1471,2024-03-18,2,3,1471000,308910,1779910
1472,2020-08-10,1,2,1472000,309120,1781120
1473,2020-03-29,1,3,1473000,309330,1782330
1474,2020-12-30,2,3,1474000,309540,1783540
1475,2023-08-15,1,3,1475000,309750,1784750
1476,2023-02-19,3,2,1476000,309960,1785960
1477,2020-10-09,3,2,1477000,310170,1787170
1478,2023-05-11,3,3,1478000,310380,1788380
1479,2020-12-02,1,3,1479000,310590,1789590
1480,2021-12-08,3,2,1480000,310800,1790800
1481,2022-10-31,2,3,1481000,311010,1792010
1482,2023-02-07,2,1,1482000,311220,1793220
1483,2024-02-21,1,3,1483000,311430,1794430
1484,2020-07-23,1,3,1484000,311640,1795640
1485,2020-08-10,3,1,1485000,311850,1796850
1486,2024-02-02,1,2,1486000,312060,1798060
1487,2023-06-28,3,3,1487000,312270,1799270
1488,2021-12-31,1,3,1488000,312480,1800480
1489,2023-07-21,1,1,1489000,312690,1801690
1490,2021-06-01,3,1,1490000,312900,1802900
1491,2022-03-02,1,3,1491000,313110,1804110
1492,2020-07-01,1,3,1492000,313320,1805320
1493,2024-04-12,1,3,1493000,313530,1806530
1494,2020-02-27,3,1,1494000,313740,1807740
1495,2020-01-10,2,1,1495000,313950,1808950
1496,2020-10-28,2,1,1496000,314160,1810160
1497,2020-06-21,1,2,1497000,314370,1811370
1498,2021-04-14,2,2,1498000,314580,1812580
1499,2023-04-07,3,1,1499000,314790,1813790
1500,2020-03-09,2,3,1500000,315000,1815000
1501,2024-01-13,1,3,1501000,315210,1816210
1502,2022-09-11,1,1,1502000,315420,1817420
1503,2021-04-09,1,2,1503000,315630,1818630
1504,2023-08-23,1,3,1504000,315840,1819840
1505,2024-10-23,3,2,1505000,316050,1821050
1506,2022-04-12,3,1,1506000,316260,1822260
1507,2024-05-07,1,1,1507000,316470,1823470
1508,2022-03-21,1,1,1508000,316680,1824680
1509,2022-10-06,3,1,1509000,316890,1825890
1510,2024-05-26,1,2,1510000,317100,1827100
1511,2022-06-09,3,3,1511000,317310,1828310
1512,2024-07-31,2,3,1512000,317520,1829520
1513,2023-03-19,1,1,1513000,317730,1830730
1514,2023-07-14,2,3,1514000,317940,1831940
1515,2020-07-05,1,1,1515000,318150,1833150
1516,2023-03-04,3,1,1516000,318360,1834360
1517,2023-01-31,3,2,1517000,318570,1835570
1518,2020-11-07,2,2,1518000,318780,1836780
1519,2020-01-03,1,1,1519000,318990,1837990
1520,2021-03-24,1,2,1520000,319200,1839200
1521,2021-07-09,1,3,1521000,319410,1840410
1522,2024-09-29,2,2,1522000,319620,1841620
1523,2021-05-04,1,2,1523000,319830,1842830
1524,2024-08-06,3,3,1524000,320040,1844040
1525,2024-12-10,3,3,1525000,320250,1845250
1526,2022-04-12,1,1,1526000,320460,1846460
1527,2022-06-24,1,2,1527000,320670,1847670
1528,2024-02-09,2,2,1528000,320880,1848880
1529,2022-04-10,1,3,1529000,321090,1850090
1530,2021-03-12,3,3,1530000,321300,1851300
1531,2020-03-18,1,2,1531000,321510,1852510
1532,2022-10-07,3,2,1532000,321720,1853720
1533,2020-02-16,2,2,1533000,321930,1854930
1534,2021-04-01,3,1,1534000,322140,1856140
1535,2022-09-02,1,3,1535000,322350,1857350
1536,2024-12-19,2,1,1536000,322560,1858560
1537,2022-07-05,2,1,1537000,322770,1859770
1538,2020-02-06,1,3,1538000,322980,1860980
1539,2024-04-08,1,3,1539000,323190,1862190
1540,2020-02-02,1,2,1540000,323400,1863400
1541,2024-10-10,3,2,1541000,323610,1864610
1542,2024-05-26,3,3,1542000,323820,1865820
1543,2022-07-02,3,1,1543000,324030,1867030
1544,2022-03-22,1,1,1544000,324240,1868240
1545,2020-06-11,1,3,1545000,324450,1869450
1546,2020-12-10,1,1,1546000,324660,1870660
1547,2021-12-04,1,2,1547000,324870,1871870
1548,2022-12-27,3,2,1548000,325080,1873080
1549,2023-09-02,2,1,1549000,325290,1874290
1550,2020-04-29,3,3,1550000,325500,1875500
1551,2024-02-14,2,2,1551000,325710,1876710
1552,2020-02-03,2,2,1552000,325920,1877920
1553,2024-10-29,3,2,1553000,326130,1879130
1554,2021-12-17,1,2,1554000,326340,1880340
1555,2020-06-15,2,1,1555000,326550,1881550
1556,2021-11-28,2,3,1556000,326760,1882760
1557,2024-06-27,1,2,1557000,326970,1883970
1558,2020-07-14,3,3,1558000,327180,1885180
1559,2020-05-15,3,1,1559000,327390,1886390
1560,2023-09-06,2,2,1560000,327600,1887600
1561,2022-01-01,3,1,1561000,327810,1888810
1562,2020-03-28,2,3,1562000,328020,1890020
1563,2020-09-26,1,2,1563000,328230,1891230
1564,2021-12-29,2,3,1564000,328440,1892440
1565,2024-07-03,3,1,1565000,328650,1893650
1566,2024-04-14,2,2,1566000,328860,1894860
1567,2021-10-03,1,1,1567000,329070,1896070
1568,2021-03-09,2,3,1568000,329280,1897280
1569,2020-06-02,3,2,1569000,329490,1898490
1570,2023-06-15,1,1,1570000,329700,1899700
1571,2024-08-20,2,1,1571000,329910,1900910
1572,2021-01-21,3,2,1572000,330120,1902120
1573,2021-03-01,2,3,1573000,330330,1903330
1574,2023-02-13,2,2,1574000,330540,1904540
1575,2022-03-14,2,1,1575000,330750,1905750
1576,2024-11-05,2,1,1576000,330960,1906960
1577,2022-01-06,1,1,1577000,331170,1908170
1578,2022-06-08,1,1,1578000,331380,1909380
1579,2021-05-20,3,3,1579000,331590,1910590
1580,2023-02-20,2,3,1580000,331800,1911800
1581,2024-03-14,1,1,1581000,332010,1913010
1582,2020-04-13,1,3,1582000,332220,1914220
1583,2023-11-23,1,2,1583000,332430,1915430
1584,2022-01-06,3,2,1584000,332640,1916640
1585,2020-05-02,3,1,1585000,332850,1917850
1586,2021-10-28,3,2,1586000,333060,1919060
1587,2024-08-18,1,2,1587000,333270,1920270
1588,2020-11-26,1,1,1588000,333480,1921480
1589,2023-05-19,3,2,1589000,333690,1922690
1590,2024-04-17,2,3,1590000,333900,1923900
1591,2022-09-22,3,1,1591000,334110,1925110
1592,2022-01-01,2,1,1592000,334320,1926320
1593,2023-03-18,2,3,1593000,334530,1927530
1594,2020-05-16,3,2,1594000,334740,1928740
1595,2021-06-20,2,1,1595000,334950,1929950
1596,2021-11-14,3,3,1596000,335160,1931160
1597,2022-04-26,2,2,1597000,335370,1932370
1598,2024-05-18,2,2,1598000,335580,1933580
1599,2020-01-03,3,3,1599000,335790,1934790
1600,2023-09-30,2,2,1600000,336000,1936000
1601,2024-03-11,3,2,1601000,336210,1937210
1602,2022-08-01,1,3,1602000,336420,1938420
1603,2020-08-25,2,2,1603000,336630,1939630
1604,2020-04-06,3,3,1604000,336840,1940840
1605,2020-08-10,3,3,1605000,337050,1942050
1606,2021-12-17,1,3,1606000,337260,1943260
1607,2021-04-02,2,3,1607000,337470,1944470
1608,2022-08-19,1,3,1608000,337680,1945680
1609,2023-12-29,2,3,1609000,337890,1946890
1610,2021-06-01,3,3,1610000,338100,1948100
1611,2024-01-14,2,2,1611000,338310,1949310
1612,2023-12-21,3,2,1612000,338520,1950520
1613,2020-08-15,2,1,1613000,338730,1951730
1614,2020-07-22,1,3,1614000,338940,1952940
1615,2023-09-26,2,1,1615000,339150,1954150
1616,2020-05-22,2,2,1616000,339360,1955360
1617,2023-11-14,1,2,1617000,339570,1956570
1618,2020-12-08,2,2,1618000,339780,1957780
1619,2023-12-16,3,1,1619000,339990,1958990
1620,2021-08-26,1,2,1620000,340200,1960200
1621,2024-05-24,3,1,1621000,340410,1961410
1622,2023-07-29,2,2,1622000,340620,1962620
1623,2023-07-09,1,2,1623000,340830,1963830
1624,2022-03-27,1,3,1624000,341040,1965040
1625,2024-12-11,2,1,1625000,341250,1966250
1626,2020-02-07,1,3,1626000,341460,1967460
1627,2022-03-02,1,2,1627000,341670,1968670
1628,2020-07-15,2,1,1628000,341880,1969880
1629,2020-04-29,1,2,1629000,342090,1971090
1630,2024-08-23,3,3,1630000,342300,1972300
1631,2023-12-21,3,1,1631000,342510,1973510
1632,2023-09-29,2,2,1632000,342720,1974720
1633,2022-07-10,3,3,1633000,342930,1975930
1634,2024-05-24,2,1,1634000,343140,1977140
1635,2023-05-15,1,3,1635000,343350,1978350
1636,2020-10-14,2,1,1636000,343560,1979560
1637,2020-09-17,3,2,1637000,343770,1980770
1638,2022-06-16,2,2,1638000,343980,1981980
1639,2024-12-04,1,1,1639000,344190,1983190
1640,2024-03-01,3,3,1640000,344400,1984400
1641,2020-12-29,2,2,1641000,344610,1985610
1642,2024-10-04,3,1,1642000,344820,1986820
1643,2023-04-16,1,2,1643000,345030,1988030
1644,2024-02-07,2,2,1644000,345240,1989240
1645,2024-11-18,1,1,1645000,345450,1990450
1646,2021-12-13,2,2,1646000,345660,1991660
1647,2022-04-06,3,3,1647000,345870,1992870
1648,2023-11-05,3,3,1648000,346080,1994080
1649,2020-08-02,2,3,1649000,346290,1995290
1650,2023-09-11,2,2,1650000,346500,1996500
1651,2023-01-18,2,1,1651000,346710,1997710
1652,2021-01-09,3,3,1652000,346920,1998920
1653,2023-04-10,3,2,1653000,347130,2000130
1654,2021-11-28,3,3,1654000,347340,2001340
1655,2023-01-24,2,3,1655000,347550,2002550
1656,2024-04-29,2,3,1656000,347760,2003760
1657,2021-10-03,1,3,1657000,347970,2004970
1658,2020-11-29,3,1,1658000,348180,2006180
1659,2020-07-15,3,1,1659000,348390,2007390
1660,2024-03-30,1,3,1660000,348600,2008600
1661,2024-12-12,2,1,1661000,348810,2009810
1662,2021-02-18,2,1,1662000,349020,2011020
1663,2024-12-08,2,3,1663000,349230,2012230
1664,2022-02-03,1,3,1664000,349440,2013440
1665,2021-09-25,2,1,1665000,349650,2014650
1666,2022-02-15,1,1,1666000,349860,2015860
1667,2023-08-03,3,1,1667000,350070,2017070
1668,2022-04-08,2,2,1668000,350280,2018280
1669,2022-09-30,3,2,1669000,350490,2019490
1670,2021-01-19,1,1,1670000,350700,2020700
1671,2021-06-10,2,2,1671000,350910,2021910
1672,2020-08-26,3,2,1672000,351120,2023120
1673,2022-04-29,1,3,1673000,351330,2024330
1674,2020-08-27,2,3,1674000,351540,2025540
1675,2023-12-01,1,1,1675000,351750,2026750
1676,2024-12-26,2,3,1676000,351960,2027960
1677,2023-12-18,1,3,1677000,352170,2029170
1678,2024-04-12,3,2,1678000,352380,2030380
1679,2022-10-23,3,1,1679000,352590,2031590
1680,2020-07-08,2,3,1680000,352800,2032800
1681,2022-03-31,3,3,1681000,353010,2034010
1682,2024-11-18,1,1,1682000,353220,2035220
1683,2024-09-01,2,2,1683000,353430,2036430
1684,2024-09-07,1,3,1684000,353640,2037640
1685,2024-01-19,3,3,1685000,353850,2038850
1686,2024-04-21,2,3,1686000,354060,2040060
1687,2024-05-17,2,2,1687000,354270,2041270
1688,2022-05-26,2,2,1688000,354480,2042480
1689,2021-10-10,1,1,1689000,354690,2043690
1690,2020-07-26,3,3,1690000,354900,2044900
1691,2020-04-15,3,2,1691000,355110,2046110
1692,2024-04-23,1,1,1692000,355320,2047320
1693,2022-05-06,3,3,1693000,355530,2048530
1694,2022-08-06,1,1,1694000,355740,2049740
1695,2022-07-21,3,3,1695000,355950,2050950
1696,2022-06-16,1,1,1696000,356160,2052160
1697,2023-09-14,2,3,1697000,356370,2053370
1698,2023-09-23,3,1,1698000,356580,2054580
1699,2024-08-21,3,1,1699000,356790,2055790
1700,2023-01-06,1,2,1700000,357000,2057000
1701,2020-11-25,2,2,1701000,357210,2058210
1702,2022-03-29,1,1,1702000,357420,2059420
1703,2023-11-17,3,2,1703000,357630,2060630
1704,2022-12-01,1,1,1704000,357840,2061840
1705,2020-05-02,3,3,1705000,358050,2063050
1706,2024-05-11,1,1,1706000,358260,2064260
1707,2024-09-13,3,3,1707000,358470,2065470
1708,2022-05-07,3,1,1708000,358680,2066680
1709,2022-10-18,3,1,1709000,358890,2067890
1710,2022-02-01,1,1,1710000,359100,2069100
1711,2023-07-21,1,3,1711000,359310,2070310
1712,2023-01-06,3,2,1712000,359520,2071520
1713,2021-09-11,2,2,1713000,359730,2072730
1714,2024-11-21,2,1,1714000,359940,2073940
1715,2022-10-24,1,3,1715000,360150,2075150
1716,2022-10-15,1,3,1716000,360360,2076360
1717,2021-12-17,3,3,1717000,360570,2077570
1718,2023-06-12,3,1,1718000,360780,2078780
1719,2023-12-29,2,1,1719000,360990,2079990
1720,2024-03-25,2,2,1720000,361200,2081200
1721,2020-02-09,3,1,1721000,361410,2082410
1722,2020-09-01,1,3,1722000,361620,2083620
1723,2024-12-07,1,2,1723000,361830,2084830
1724,2024-10-29,3,2,1724000,362040,2086040
1725,2022-04-09,1,1,1725000,362250,2087250
1726,2020-02-22,2,3,1726000,362460,2088460
1727,2022-12-28,1,2,1727000,362670,2089670
1728,2020-03-29,1,1,1728000,362880,2090880
1729,2021-05-30,1,3,1729000,363090,2092090
1730,2021-05-02,2,3,1730000,363300,2093300
1731,2020-03-16,2,1,1731000,363510,2094510
1732,2020-06-30,2,3,1732000,363720,2095720
1733,2020-12-06,2,3,1733000,363930,2096930
1734,2020-10-26,1,3,1734000,364140,2098140
1735,2023-07-25,2,1,1735000,364350,2099350
1736,2020-09-22,1,2,1736000,364560,2100560
1737,2021-04-03,1,2,1737000,364770,2101770
1738,2020-04-07,2,2,1738000,364980,2102980
1739,2020-10-31,1,1,1739000,365190,2104190
1740,2021-02-01,3,3,1740000,365400,2105400
1741,2020-03-10,1,2,1741000,365610,2106610
1742,2021-05-13,3,3,1742000,365820,2107820
1743,2021-06-17,2,3,1743000,366030,2109030
1744,2023-01-22,3,2,1744000,366240,2110240
1745,2024-01-21,2,2,1745000,366450,2111450
1746,2021-07-19,2,1,1746000,366660,2112660
1747,2023-06-11,1,2,1747000,366870,2113870
1748,2022-08-11,3,1,1748000,367080,2115080
1749,2020-10-24,3,3,1749000,367290,2116290
1750,2020-09-26,1,3,1750000,367500,2117500
1751,2021-09-14,3,2,1751000,367710,2118710
1752,2022-03-20,1,1,1752000,367920,2119920
1753,2021-12-17,3,2,1753000,368130,2121130
1754,2021-11-24,3,2,1754000,368340,2122340
1755,2020-05-20,1,3,1755000,368550,2123550
1756,2021-10-27,2,2,1756000,368760,2124760
1757,2023-11-27,2,2,1757000,368970,2125970
1758,2022-12-03,1,2,1758000,369180,2127180
1759,2022-10-30,3,2,1759000,369390,2128390
1760,2024-12-23,2,3,1760000,369600,2129600
1761,2023-12-12,3,2,1761000,369810,2130810
1762,2023-09-24,3,3,1762000,370020,2132020
1763,2023-01-01,1,1,1763000,370230,2133230
1764,2021-10-15,3,3,1764000,370440,2134440
1765,2023-09-01,1,2,1765000,370650,2135650
1766,2022-08-09,1,1,1766000,370860,2136860
1767,2023-11-09,2,2,1767000,371070,2138070
1768,2023-11-10,2,3,1768000,371280,2139280
1769,2020-03-23,1,3,1769000,371490,2140490
1770,2020-12-07,3,3,1770000,371700,2141700
1771,2021-01-31,2,1,1771000,371910,2142910
1772,2021-07-06,3,3,1772000,372120,2144120
1773,2024-03-29,2,2,1773000,372330,2145330
1774,2023-04-16,3,3,1774000,372540,2146540
1775,2021-07-26,3,1,1775000,372750,2147750
1776,2023-04-29,1,2,1776000,372960,2148960
1777,2024-04-05,3,1,1777000,373170,2150170
1778,2020-06-20,3,3,1778000,373380,2151380
1779,2023-09-07,3,3,1779000,373590,2152590
1780,2020-11-27,2,3,1780000,373800,2153800
1781,2022-08-26,3,3,1781000,374010,2155010
1782,2022-11-30,2,2,1782000,374220,2156220
1783,2020-12-17,3,2,1783000,374430,2157430
1784,2021-01-08,2,1,1784000,374640,2158640
1785,2021-11-25,1,1,1785000,374850,2159850
1786,2024-01-23,1,2,1786000,375060,2161060
1787,2022-01-26,3,3,1787000,375270,2162270
1788,2020-05-21,3,2,1788000,375480,2163480
1789,2024-01-15,3,3,1789000,375690,2164690
1790,2023-05-25,1,1,1790000,375900,2165900
1791,2022-11-03,3,2,1791000,376110,2167110
1792,2022-05-21,1,2,1792000,376320,2168320
1793,2022-07-23,1,2,1793000,376530,2169530
1794,2023-12-04,1,3,1794000,376740,2170740
1795,2022-05-01,1,1,1795000,376950,2171950
1796,2023-11-09,1,1,1796000,377160,2173160
1797,2022-04-18,1,2,1797000,377370,2174370
1798,2022-07-19,2,1,1798000,377580,2175580
1799,2024-03-06,3,2,1799000,377790,2176790
1800,2021-11-22,1,3,1800000,378000,2178000
1801,2024-03-15,2,1,1801000,378210,2179210
1802,2022-12-22,2,2,1802000,378420,2180420
1803,2024-06-20,2,1,1803000,378630,2181630
1804,2020-12-17,3,3,1804000,378840,2182840
1805,2021-04-16,2,3,1805000,379050,2184050
1806,2020-02-23,2,1,1806000,379260,2185260
1807,2022-05-17,3,2,1807000,379470,2186470
1808,2022-10-17,2,1,1808000,379680,2187680
1809,2020-05-20,3,1,1809000,379890,2188890
1810,2021-03-08,1,1,1810000,380100,2190100
1811,2021-11-20,3,1,1811000,380310,2191310
1812,2024-10-15,3,1,1812000,380520,2192520
1813,2023-03-04,3,1,1813000,380730,2193730
1814,2024-10-11,1,3,1814000,380940,2194940
1815,2022-12-27,1,2,1815000,381150,2196150
1816,2020-08-04,1,3,1816000,381360,2197360
1817,2022-11-08,1,1,1817000,381570,2198570
1818,2021-08-29,1,2,1818000,381780,2199780
1819,2021-08-21,2,3,1819000,381990,2200990
1820,2020-11-24,1,2,1820000,382200,2202200
1821,2023-03-09,1,2,1821000,382410,2203410
1822,2020-09-26,1,3,1822000,382620,2204620
1823,2023-04-11,2,2,1823000,382830,2205830
1824,2022-06-26,3,2,1824000,383040,2207040
1825,2022-08-18,3,1,1825000,383250,2208250
1826,2023-07-02,3,2,1826000,383460,2209460
1827,2023-08-20,1,2,1827000,383670,2210670
1828,2024-05-14,1,2,1828000,383880,2211880
1829,2020-07-25,1,3,1829000,384090,2213090
1830,2022-06-17,3,1,1830000,384300,2214300
1831,2020-03-01,1,2,1831000,384510,2215510
1832,2020-06-07,3,3,1832000,384720,2216720
1833,2024-09-09,3,2,1833000,384930,2217930
1834,2024-01-31,1,3,1834000,385140,2219140
1835,2020-10-04,1,2,1835000,385350,2220350
1836,2020-01-29,1,1,1836000,385560,2221560
1837,2021-10-23,1,1,1837000,385770,2222770
1838,2023-12-13,3,1,1838000,385980,2223980
1839,2024-10-06,2,3,1839000,386190,2225190
1840,2023-09-11,2,3,1840000,386400,2226400
1841,2023-06-19,2,2,1841000,386610,2227610
1842,2021-06-22,2,1,1842000,386820,2228820
1843,2021-06-10,2,3,1843000,387030,2230030
1844,2024-10-20,3,3,1844000,387240,2231240
1845,2022-02-21,3,1,1845000,387450,2232450
1846,2022-04-23,1,3,1846000,387660,2233660
1847,2021-12-14,2,3,1847000,387870,2234870
1848,2021-09-03,3,1,1848000,388080,2236080
1849,2020-01-05,1,2,1849000,388290,2237290
1850,2022-06-17,1,1,1850000,388500,2238500
1851,2024-09-01,3,1,1851000,388710,2239710
1852,2020-01-26,3,1,1852000,388920,2240920
1853,2022-09-01,3,3,1853000,389130,2242130
1854,2021-06-11,2,3,1854000,389340,2243340
1855,2020-08-22,1,3,1855000,389550,2244550
1856,2021-07-04,2,1,1856000,389760,2245760
1857,2023-06-07,1,2,1857000,389970,2246970
1858,2024-11-05,2,1,1858000,390180,2248180
1859,2021-01-04,3,1,1859000,390390,2249390
1860,2022-01-08,1,3,1860000,390600,2250600
1861,2024-06-06,1,2,1861000,390810,2251810
1862,2020-01-09,2,2,1862000,391020,2253020
1863,2023-07-26,2,2,1863000,391230,2254230
1864,2020-01-09,3,3,1864000,391440,2255440
1865,2021-09-14,3,2,1865000,391650,2256650
1866,2023-06-05,1,3,1866000,391860,2257860
1867,2024-07-12,2,2,1867000,392070,2259070
1868,2024-11-23,3,3,1868000,392280,2260280
1869,2021-02-01,1,3,1869000,392490,2261490
1870,2022-12-21,2,2,1870000,392700,2262700
1871,2022-09-22,3,3,1871000,392910,2263910
1872,2021-03-14,2,1,1872000,393120,2265120
1873,2020-10-06,3,2,1873000,393330,2266330
1874,2022-12-30,3,2,1874000,393540,2267540
1875,2024-11-20,2,1,1875000,393750,2268750
1876,2022-05-10,1,1,1876000,393960,2269960
1877,2024-07-10,3,2,1877000,394170,2271170
1878,2023-11-08,3,3,1878000,394380,2272380
1879,2020-06-24,2,3,1879000,394590,2273590
1880,2021-04-13,1,3,1880000,394800,2274800
1881,2022-10-01,3,2,1881000,395010,2276010
1882,2021-10-09,3,2,1882000,395220,2277220
1883,2024-10-06,3,2,1883000,395430,2278430
1884,2020-04-29,2,2,1884000,395640,2279640
1885,2022-10-20,2,1,1885000,395850,2280850
1886,2024-11-19,2,3,1886000,396060,2282060
1887,2022-08-14,1,2,1887000,396270,2283270
1888,2023-02-13,1,2,1888000,396480,2284480
1889,2020-09-29,1,1,1889000,396690,2285690
1890,2021-04-11,2,1,1890000,396900,2286900
1891,2023-02-11,1,2,1891000,397110,2288110
1892,2020-03-01,1,2,1892000,397320,2289320
1893,2023-10-20,2,2,1893000,397530,2290530
1894,2021-03-03,3,1,1894000,397740,2291740
1895,2021-02-09,3,2,1895000,397950,2292950
1896,2020-05-13,1,3,1896000,398160,2294160
1897,2020-12-24,3,2,1897000,398370,2295370
1898,2023-06-19,3,3,1898000,398580,2296580
1899,2020-08-17,1,1,1899000,398790,2297790
1900,2023-08-17,2,2,1900000,399000,2299000
1901,2024-02-27,3,2,1901000,399210,2300210
1902,2024-03-01,2,3,1902000,399420,2301420
1903,2020-09-03,1,1,1903000,399630,2302630
1904,2023-09-20,2,3,1904000,399840,2303840
1905,2022-07-06,3,2,1905000,400050,2305050
1906,2024-04-05,2,2,1906000,400260,2306260
1907,2021-08-23,2,3,1907000,400470,2307470
1908,2020-05-02,2,2,1908000,400680,2308680
1909,2021-12-15,1,1,1909000,400890,2309890
1910,2021-03-11,3,1,1910000,401100,2311100
1911,2024-08-25,1,1,1911000,401310,2312310
1912,2024-03-17,1,1,1912000,401520,2313520
1913,2024-12-26,2,3,1913000,401730,2314730
1914,2020-03-05,3,2,1914000,401940,2315940
1915,2024-08-22,1,2,1915000,402150,2317150
1916,2020-11-07,3,1,1916000,402360,2318360
1917,2024-02-28,1,1,1917000,402570,2319570
1918,2021-12-23,2,1,1918000,402780,2320780
1919,2023-10-08,2,3,1919000,402990,2321990
1920,2021-10-19,2,1,1920000,403200,2323200
1921,2022-08-12,3,3,1921000,403410,2324410
1922,2020-10-16,3,1,1922000,403620,2325620
1923,2024-01-06,3,1,1923000,403830,2326830
1924,2020-01-09,1,2,1924000,404040,2328040
1925,2021-07-19,2,1,1925000,404250,2329250
1926,2023-05-05,1,2,1926000,404460,2330460
1927,2024-04-15,1,3,1927000,404670,2331670
1928,2023-03-21,3,2,1928000,404880,2332880
1929,2023-05-03,1,1,1929000,405090,2334090
1930,2021-06-05,2,2,1930000,405300,2335300
1931,2021-10-21,2,2,1931000,405510,2336510
1932,2022-03-11,3,1,1932000,405720,2337720
1933,2024-05-11,3,1,1933000,405930,2338930
1934,2020-03-19,2,2,1934000,406140,2340140
1935,2022-09-22,2,3,1935000,406350,2341350
1936,2024-07-11,3,1,1936000,406560,2342560
1937,2024-09-06,1,2,1937000,406770,2343770
1938,2023-06-24,3,3,1938000,406980,2344980
1939,2020-05-23,2,3,1939000,407190,2346190
1940,2023-01-13,3,1,1940000,407400,2347400
1941,2023-02-16,1,2,1941000,407610,2348610
1942,2024-05-07,3,1,1942000,407820,2349820
1943,2022-04-05,3,2,1943000,408030,2351030
1944,2024-03-20,2,3,1944000,408240,2352240
1945,2023-11-04,3,1,1945000,408450,2353450
1946,2022-11-24,2,2,1946000,408660,2354660
1947,2020-06-28,3,2,1947000,408870,2355870
1948,2024-02-17,3,3,1948000,409080,2357080
1949,2021-11-22,2,1,1949000,409290,2358290
1950,2020-11-28,2,2,1950000,409500,2359500
1951,2021-08-01,3,2,1951000,409710,2360710
1952,2023-07-23,1,3,1952000,409920,2361920
1953,2024-05-19,1,2,1953000,410130,2363130
1954,2021-12-27,3,2,1954000,410340,2364340
1955,2023-10-28,2,3,1955000,410550,2365550
1956,2021-07-04,2,2,1956000,410760,2366760
1957,2021-10-13,2,3,1957000,410970,2367970
1958,2020-04-07,2,3,1958000,411180,2369180
1959,2021-04-08,1,2,1959000,411390,2370390
1960,2023-08-06,2,3,1960000,411600,2371600
1961,2022-05-14,2,2,1961000,411810,2372810
1962,2023-04-22,3,1,1962000,412020,2374020
1963,2022-08-04,2,1,1963000,412230,2375230
1964,2021-12-10,2,3,1964000,412440,2376440
1965,2024-09-03,2,3,1965000,412650,2377650
1966,2020-10-24,1,2,1966000,412860,2378860
1967,2022-01-27,3,1,1967000,413070,2380070
1968,2020-05-06,2,3,1968000,413280,2381280
1969,2020-12-26,3,1,1969000,413490,2382490
1970,2022-06-14,2,2,1970000,413700,2383700
1971,2021-06-28,2,3,1971000,413910,2384910
1972,2022-11-29,1,1,1972000,414120,2386120
1973,2020-03-15,1,1,1973000,414330,2387330
1974,2022-07-07,3,3,1974000,414540,2388540
1975,2024-03-01,3,2,1975000,414750,2389750
1976,2023-06-26,2,3,1976000,414960,2390960
1977,2020-09-20,3,3,1977000,415170,2392170
1978,2021-03-08,2,3,1978000,415380,2393380
1979,2023-01-08,1,1,1979000,415590,2394590
1980,2020-03-30,1,2,1980000,415800,2395800
1981,2020-07-01,1,1,1981000,416010,2397010
1982,2021-06-08,3,3,1982000,416220,2398220
1983,2021-08-06,3,3,1983000,416430,2399430
1984,2024-02-16,3,2,1984000,416640,2400640
1985,2020-07-30,3,3,1985000,416850,2401850
1986,2024-11-24,3,2,1986000,417060,2403060
1987,2024-06-24,2,1,1987000,417270,2404270
1988,2024-07-04,2,1,1988000,417480,2405480
1989,2022-04-27,2,2,1989000,417690,2406690
1990,2020-10-14,1,2,1990000,417900,2407900
1991,2024-10-24,3,3,1991000,418110,2409110
1992,2023-03-23,2,3,1992000,418320,2410320
1993,2022-02-15,1,1,1993000,418530,2411530
1994,2024-02-22,1,1,1994000,418740,2412740
1995,2023-06-12,3,2,1995000,418950,2413950
1996,2024-08-24,3,3,1996000,419160,2415160
1997,2020-10-30,3,2,1997000,419370,2416370
1998,2020-08-04,1,3,1998000,419580,2417580
1999,2023-12-04,1,3,1999000,419790,2418790
2000,2024-07-20,3,3,2000000,420000,2420000
2001,2021-05-15,1,1,2001000,420210,2421210
2002,2021-02-19,3,2,2002000,420420,2422420
2003,2024-01-17,3,3,2003000,420630,2423630
2004,2023-04-24,3,3,2004000,420840,2424840
2005,2024-11-25,1,2,2005000,421050,2426050
2006,2024-01-22,3,2,2006000,421260,2427260
2007,2024-11-10,1,2,2007000,421470,2428470
2008,2022-11-01,2,2,2008000,421680,2429680
2009,2021-02-14,1,2,2009000,421890,2430890
2010,2023-09-28,3,3,2010000,422100,2432100
2011,2023-06-16,3,2,2011000,422310,2433310
2012,2020-11-17,1,1,2012000,422520,2434520
2013,2024-02-03,2,2,2013000,422730,2435730
2014,2024-08-13,2,2,2014000,422940,2436940
2015,2021-11-05,3,1,2015000,423150,2438150
2016,2020-02-29,3,3,2016000,423360,2439360
2017,2022-11-30,3,2,2017000,423570,2440570
2018,2021-09-25,1,1,2018000,423780,2441780
2019,2022-04-22,2,1,2019000,423990,2442990
2020,2024-05-14,1,2,2020000,424200,2444200
2021,2021-01-06,2,1,2021000,424410,2445410
2022,2024-09-16,1,1,2022000,424620,2446620
2023,2023-03-06,1,3,2023000,424830,2447830
2024,2020-08-18,1,3,2024000,425040,2449040
2025,2020-11-22,3,2,2025000,425250,2450250
2026,2024-06-13,3,3,2026000,425460,2451460
2027,2022-02-11,3,1,2027000,425670,2452670
2028,2022-09-13,2,3,2028000,425880,2453880
2029,2024-04-26,3,2,2029000,426090,2455090
2030,2020-08-01,3,1,2030000,426300,2456300
2031,2021-11-22,1,2,2031000,426510,2457510
2032,2024-12-28,2,1,2032000,426720,2458720
2033,2021-04-08,2,2,2033000,426930,2459930
2034,2020-03-16,1,3,2034000,427140,2461140
2035,2023-02-10,2,2,2035000,427350,2462350
2036,2024-07-17,1,2,2036000,427560,2463560
2037,2023-06-07,3,2,2037000,427770,2464770
2038,2021-07-09,3,3,2038000,427980,2465980
2039,2024-01-31,2,1,2039000,428190,2467190
2040,2022-03-07,3,3,2040000,428400,2468400
2041,2020-12-05,3,1,2041000,428610,2469610
2042,2020-01-04,1,1,2042000,428820,2470820
2043,2020-04-25,3,1,2043000,429030,2472030
2044,2022-06-17,3,3,2044000,429240,2473240
2045,2021-02-21,3,1,2045000,429450,2474450
2046,2024-10-17,3,3,2046000,429660,2475660
2047,2023-09-22,1,3,2047000,429870,2476870
2048,2022-11-22,1,1,2048000,430080,2478080
2049,2020-04-11,1,3,2049000,430290,2479290
2050,2022-03-27,3,3,2050000,430500,2480500
2051,2021-01-25,1,3,2051000,430710,2481710
2052,2022-02-20,2,2,2052000,430920,2482920
2053,2022-06-24,1,2,2053000,431130,2484130
2054,2023-02-15,2,2,2054000,431340,2485340
2055,2023-03-01,2,2,2055000,431550,2486550
2056,2023-05-08,2,3,2056000,431760,2487760
2057,2022-12-08,3,1,2057000,431970,2488970
2058,2024-08-13,2,2,2058000,432180,2490180
2059,2022-08-02,3,3,2059000,432390,2491390
2060,2023-07-05,3,2,2060000,432600,2492600
2061,2021-11-29,3,1,2061000,432810,2493810
2062,2023-11-26,1,2,2062000,433020,2495020
2063,2023-06-22,2,2,2063000,433230,2496230
2064,2022-10-21,2,2,2064000,433440,2497440
2065,2024-12-27,1,2,2065000,433650,2498650
2066,2021-06-01,2,3,2066000,433860,2499860
2067,2023-09-20,1,1,2067000,434070,2501070
2068,2020-06-14,1,1,2068000,434280,2502280
2069,2020-01-12,3,2,2069000,434490,2503490
2070,2024-05-30,1,2,2070000,434700,2504700
2071,2021-02-10,1,2,2071000,434910,2505910
2072,2022-01-15,2,3,2072000,435120,2507120
2073,2022-12-26,2,1,2073000,435330,2508330
2074,2024-12-18,3,1,2074000,435540,2509540
2075,2023-11-16,1,2,2075000,435750,2510750
2076,2022-11-22,3,3,2076000,435960,2511960
2077,2021-07-14,3,3,2077000,436170,2513170
2078,2020-05-10,3,3,2078000,436380,2514380
2079,2020-08-20,2,1,2079000,436590,2515590
2080,2021-06-29,1,1,2080000,436800,2516800
2081,2022-04-02,2,3,2081000,437010,2518010
2082,2023-05-19,3,3,2082000,437220,2519220
2083,2022-09-25,2,1,2083000,437430,2520430
2084,2024-03-03,2,2,2084000,437640,2521640
2085,2020-04-11,1,1,2085000,437850,2522850
2086,2020-08-25,2,1,2086000,438060,2524060
2087,2021-08-21,2,2,2087000,438270,2525270
2088,2020-01-31,3,3,2088000,438480,2526480
2089,2021-07-15,3,2,2089000,438690,2527690
2090,2023-12-10,1,2,2090000,438900,2528900
2091,2020-02-17,2,3,2091000,439110,2530110
2092,2022-05-27,3,3,2092000,439320,2531320
2093,2022-07-18,2,1,2093000,439530,2532530
2094,2020-12-25,1,1,2094000,439740,2533740
2095,2022-09-07,2,1,2095000,439950,2534950
2096,2020-12-29,2,1,2096000,440160,2536160
2097,2020-05-15,3,2,2097000,440370,2537370
2098,2024-05-20,2,2,2098000,440580,2538580
2099,2023-05-11,3,2,2099000,440790,2539790
2100,2022-03-28,2,2,2100000,441000,2541000
2101,2021-05-13,2,2,2101000,441210,2542210
2102,2020-05-06,2,1,2102000,441420,2543420
2103,2021-07-21,1,1,2103000,441630,2544630
2104,2023-07-12,1,1,2104000,441840,2545840
2105,2021-06-14,1,1,2105000,442050,2547050
2106,2020-08-13,2,2,2106000,442260,2548260
2107,2022-01-31,1,2,2107000,442470,2549470
2108,2024-09-04,1,2,2108000,442680,2550680
2109,2021-03-10,3,3,2109000,442890,2551890
2110,2020-10-26,2,2,2110000,443100,2553100
2111,2020-09-09,2,3,2111000,443310,2554310
2112,2021-04-03,2,2,2112000,443520,2555520
2113,2020-10-01,1,2,2113000,443730,2556730
2114,2020-03-31,2,3,2114000,443940,2557940
2115,2020-02-24,3,1,2115000,444150,2559150
2116,2020-08-14,2,3,2116000,444360,2560360
2117,2024-10-13,1,1,2117000,444570,2561570
2118,2021-04-27,2,1,2118000,444780,2562780
2119,2023-04-15,2,2,2119000,444990,2563990
2120,2020-07-31,2,3,2120000,445200,2565200
2121,2024-09-12,3,2,2121000,445410,2566410
2122,2021-04-20,1,3,2122000,445620,2567620
2123,2024-09-16,2,3,2123000,445830,2568830
2124,2024-12-27,2,1,2124000,446040,2570040
2125,2021-12-26,2,1,2125000,446250,2571250
2126,2020-11-16,2,3,2126000,446460,2572460
2127,2024-11-12,3,3,2127000,446670,2573670
2128,2024-12-02,3,2,2128000,446880,2574880
2129,2021-09-30,2,2,2129000,447090,2576090
2130,2020-05-23,2,1,2130000,447300,2577300
2131,2020-12-19,1,3,2131000,447510,2578510
2132,2022-01-29,3,2,2132000,447720,2579720
2133,2022-05-25,1,1,2133000,447930,2580930
2134,2023-07-12,1,1,2134000,448140,2582140
2135,2020-08-16,2,2,2135000,448350,2583350
2136,2020-06-13,3,3,2136000,448560,2584560
2137,2020-11-13,1,1,2137000,448770,2585770
2138,2021-02-07,1,3,2138000,448980,2586980
2139,2023-04-21,1,2,2139000,449190,2588190
2140,2023-12-08,3,3,2140000,449400,2589400
2141,2022-06-18,3,1,2141000,449610,2590610
2142,2024-11-12,1,2,2142000,449820,2591820
2143,2021-04-30,3,1,2143000,450030,2593030
2144,2021-11-06,1,2,2144000,450240,2594240
2145,2020-07-21,2,1,2145000,450450,2595450
2146,2024-03-26,2,1,2146000,450660,2596660
2147,2021-04-01,1,1,2147000,450870,2597870
2148,2024-01-24,1,2,2148000,451080,2599080
2149,2023-09-28,3,2,2149000,451290,2600290
2150,2020-03-04,1,3,2150000,451500,2601500
2151,2021-12-09,3,3,2151000,451710,2602710
2152,2022-07-04,1,1,2152000,451920,2603920
2153,2020-07-12,3,3,2153000,452130,2605130
2154,2022-03-03,3,1,2154000,452340,2606340
2155,2022-06-12,2,2,2155000,452550,2607550
2156,2022-12-03,1,1,2156000,452760,2608760
2157,2020-08-02,2,1,2157000,452970,2609970
2158,2024-01-01,2,2,2158000,453180,2611180
2159,2020-04-11,2,1,2159000,453390,2612390
2160,2021-11-14,1,3,2160000,453600,2613600
2161,2020-08-16,2,1,2161000,453810,2614810
2162,2020-09-13,3,2,2162000,454020,2616020
2163,2020-03-15,2,3,2163000,454230,2617230
2164,2020-02-06,3,3,2164000,454440,2618440
2165,2024-11-20,2,3,2165000,454650,2619650
2166,2022-04-19,1,2,2166000,454860,2620860
2167,2020-05-19,3,2,2167000,455070,2622070
2168,2020-06-19,1,1,2168000,455280,2623280
2169,2024-07-18,1,2,2169000,455490,2624490
2170,2024-10-27,3,1,2170000,455700,2625700
2171,2024-12-12,2,2,2171000,455910,2626910
2172,2020-06-21,2,1,2172000,456120,2628120
2173,2024-04-14,2,2,2173000,456330,2629330
2174,2024-08-04,2,1,2174000,456540,2630540
2175,2024-04-07,1,2,2175000,456750,2631750
2176,2021-05-28,3,1,2176000,456960,2632960
2177,2021-02-07,1,3,2177000,457170,2634170
2178,2022-08-19,3,1,2178000,457380,2635380
2179,2020-08-18,3,2,2179000,457590,2636590
2180,2023-05-11,1,2,2180000,457800,2637800
2181,2023-07-26,3,1,2181000,458010,2639010
2182,2021-08-09,3,1,2182000,458220,2640220
2183,2024-01-06,1,2,2183000,458430,2641430
2184,2024-05-12,2,2,2184000,458640,2642640
2185,2021-12-25,3,1,2185000,458850,2643850
2186,2021-01-09,2,3,2186000,459060,2645060
2187,2020-07-04,3,3,2187000,459270,2646270
2188,2023-10-28,2,2,2188000,459480,2647480
2189,2022-04-09,3,2,2189000,459690,2648690
2190,2024-08-26,3,1,2190000,459900,2649900
2191,2023-08-30,1,3,2191000,460110,2651110
2192,2021-10-28,3,1,2192000,460320,2652320
2193,2024-12-12,3,1,2193000,460530,2653530
2194,2024-02-19,2,1,2194000,460740,2654740
2195,2021-03-10,3,2,2195000,460950,2655950
2196,2023-08-12,3,2,2196000,461160,2657160
2197,2020-07-21,3,2,2197000,461370,2658370
2198,2022-09-20,3,2,2198000,461580,2659580
2199,2022-12-07,2,3,2199000,461790,2660790
2200,2020-02-28,1,2,2200000,462000,2662000
2201,2022-09-05,2,3,2201000,462210,2663210
2202,2023-12-05,3,1,2202000,462420,2664420
2203,2023-04-28,2,1,2203000,462630,2665630
2204,2022-02-26,1,3,2204000,462840,2666840
2205,2020-06-05,3,3,2205000,463050,2668050
2206,2022-10-10,2,2,2206000,463260,2669260
2207,2020-06-01,2,1,2207000,463470,2670470
2208,2020-02-04,2,2,2208000,463680,2671680
2209,2023-01-19,2,3,2209000,463890,2672890
2210,2023-10-10,2,1,2210000,464100,2674100
2211,2023-09-20,2,3,2211000,464310,2675310
2212,2022-08-23,1,1,2212000,464520,2676520
2213,2022-10-24,1,3,2213000,464730,2677730
2214,2021-01-04,3,3,2214000,464940,2678940
2215,2020-02-10,1,1,2215000,465150,2680150
2216,2024-04-29,2,3,2216000,465360,2681360
2217,2024-03-25,3,1,2217000,465570,2682570
2218,2021-10-04,1,3,2218000,465780,2683780
2219,2020-05-21,2,2,2219000,465990,2684990
2220,2021-11-02,3,1,2220000,466200,2686200
2221,2024-10-08,2,3,2221000,466410,2687410
2222,2021-09-02,1,1,2222000,466620,2688620
2223,2020-06-29,3,2,2223000,466830,2689830
2224,2020-03-10,3,3,2224000,467040,2691040
2225,2021-05-22,1,2,2225000,467250,2692250
2226,2020-11-01,2,1,2226000,467460,2693460
2227,2020-01-02,1,2,2227000,467670,2694670
2228,2022-08-20,1,2,2228000,467880,2695880
2229,2024-05-12,1,2,2229000,468090,2697090
2230,2021-02-05,2,3,2230000,468300,2698300
2231,2024-09-11,3,3,2231000,468510,2699510
2232,2020-02-08,1,3,2232000,468720,2700720
2233,2022-05-27,2,1,2233000,468930,2701930
2234,2021-12-12,2,1,2234000,469140,2703140
2235,2023-04-24,3,2,2235000,469350,2704350
2236,2023-12-27,3,1,2236000,469560,2705560
2237,2024-09-20,1,2,2237000,469770,2706770
2238,2022-08-12,3,3,2238000,469980,2707980
2239,2020-09-21,2,3,2239000,470190,2709190
2240,2022-09-30,3,1,2240000,470400,2710400
2241,2020-12-08,2,1,2241000,470610,2711610
2242,2024-08-06,2,3,2242000,470820,2712820
2243,2022-09-19,2,1,2243000,471030,2714030
2244,2023-03-31,1,3,2244000,471240,2715240
2245,2021-09-12,1,1,2245000,471450,2716450
2246,2020-10-17,3,2,2246000,471660,2717660
2247,2020-04-21,3,3,2247000,471870,2718870
2248,2020-03-07,3,3,2248000,472080,2720080
2249,2024-12-24,3,1,2249000,472290,2721290
2250,2020-11-23,3,1,2250000,472500,2722500
2251,2022-12-03,3,2,2251000,472710,2723710
2252,2020-04-02,3,1,2252000,472920,2724920
2253,2020-06-10,3,2,2253000,473130,2726130
2254,2020-10-07,1,1,2254000,473340,2727340
2255,2022-02-04,1,2,2255000,473550,2728550
2256,2020-11-26,3,1,2256000,473760,2729760
2257,2024-12-02,3,3,2257000,473970,2730970
2258,2020-09-22,2,2,2258000,474180,2732180
2259,2021-02-03,2,3,2259000,474390,2733390
2260,2020-12-23,3,3,2260000,474600,2734600
2261,2020-07-27,3,3,2261000,474810,2735810
2262,2021-12-10,3,2,2262000,475020,2737020
2263,2021-11-27,1,2,2263000,475230,2738230
2264,2022-07-22,1,3,2264000,475440,2739440
2265,2023-12-14,3,1,2265000,475650,2740650
2266,2023-05-15,3,1,2266000,475860,2741860
2267,2024-06-28,1,1,2267000,476070,2743070
2268,2023-02-03,2,2,2268000,476280,2744280
2269,2022-11-06,1,3,2269000,476490,2745490
2270,2022-07-21,3,1,2270000,476700,2746700
2271,2022-09-20,2,2,2271000,476910,2747910
2272,2023-09-05,2,3,2272000,477120,2749120
2273,2023-12-01,2,1,2273000,477330,2750330
2274,2023-09-17,3,1,2274000,477540,2751540
2275,2020-01-07,2,1,2275000,477750,2752750
2276,2023-03-08,1,3,2276000,477960,2753960
2277,2023-01-01,1,2,2277000,478170,2755170
2278,2021-12-04,3,3,2278000,478380,2756380
2279,2022-11-13,3,1,2279000,478590,2757590
2280,2021-04-17,2,1,2280000,478800,2758800
2281,2022-08-12,2,3,2281000,479010,2760010
2282,2020-11-26,1,3,2282000,479220,2761220
2283,2022-09-15,2,2,2283000,479430,2762430
2284,2022-08-14,1,1,2284000,479640,2763640
2285,2024-01-10,1,2,2285000,479850,2764850
2286,2020-09-18,3,3,2286000,480060,2766060
2287,2024-10-27,3,1,2287000,480270,2767270
2288,2023-04-19,2,1,2288000,480480,2768480
2289,2022-08-15,2,2,2289000,480690,2769690
2290,2020-10-17,2,1,2290000,480900,2770900
2291,2021-02-17,3,1,2291000,481110,2772110
2292,2022-01-04,2,1,2292000,481320,2773320
2293,2023-11-13,1,3,2293000,481530,2774530
2294,2023-01-04,1,3,2294000,481740,2775740
2295,2022-03-02,2,1,2295000,481950,2776950
2296,2022-05-31,1,1,2296000,482160,2778160
2297,2024-04-06,2,2,2297000,482370,2779370
2298,2020-04-22,3,2,2298000,482580,2780580
2299,2021-11-29,1,2,2299000,482790,2781790
2300,2021-12-30,3,1,2300000,483000,2783000
2301,2021-08-01,1,3,2301000,483210,2784210
2302,2020-07-29,1,3,2302000,483420,2785420
2303,2020-02-27,2,3,2303000,483630,2786630
2304,2022-02-17,1,2,2304000,483840,2787840
2305,2024-04-29,1,2,2305000,484050,2789050
2306,2023-06-08,1,1,2306000,484260,2790260
2307,2024-09-11,3,1,2307000,484470,2791470
2308,2020-11-26,2,3,2308000,484680,2792680
2309,2024-01-07,3,1,2309000,484890,2793890
2310,2022-09-26,1,1,2310000,485100,2795100
2311,2020-09-06,2,2,2311000,485310,2796310
2312,2021-08-14,2,3,2312000,485520,2797520
2313,2021-03-17,1,1,2313000,485730,2798730
2314,2020-10-27,2,3,2314000,485940,2799940
2315,2022-04-28,1,2,2315000,486150,2801150
2316,2020-04-07,1,2,2316000,486360,2802360
2317,2024-10-29,2,3,2317000,486570,2803570
2318,2020-01-06,1,3,2318000,486780,2804780
2319,2024-04-28,2,2,2319000,486990,2805990
2320,2022-09-13,1,2,2320000,487200,2807200
2321,2023-10-20,1,1,2321000,487410,2808410
2322,2020-05-29,3,2,2322000,487620,2809620
2323,2024-02-25,3,3,2323000,487830,2810830
2324,2022-10-31,1,1,2324000,488040,2812040
2325,2023-12-08,2,1,2325000,488250,2813250
2326,2023-11-21,1,1,2326000,488460,2814460
2327,2020-02-19,1,1,2327000,488670,2815670
2328,2022-07-18,3,3,2328000,488880,2816880
2329,2023-02-11,1,2,2329000,489090,2818090
2330,2022-01-03,1,3,2330000,489300,2819300
2331,2024-03-27,1,3,2331000,489510,2820510
2332,2023-02-28,3,2,2332000,489720,2821720
2333,2024-07-03,2,1,2333000,489930,2822930
2334,2020-03-23,3,3,2334000,490140,2824140
2335,2021-09-21,1,3,2335000,490350,2825350
2336,2022-11-18,3,1,2336000,490560,2826560
2337,2022-07-07,2,1,2337000,490770,2827770
2338,2024-12-08,3,3,2338000,490980,2828980
2339,2020-05-12,2,1,2339000,491190,2830190
2340,2023-04-29,2,1,2340000,491400,2831400
2341,2023-04-19,2,1,2341000,491610,2832610
2342,2022-07-20,3,1,2342000,491820,2833820
2343,2021-10-01,2,3,2343000,492030,2835030
2344,2020-01-09,3,3,2344000,492240,2836240
2345,2020-05-24,3,1,2345000,492450,2837450
2346,2024-08-27,1,3,2346000,492660,2838660
2347,2022-01-02,2,3,2347000,492870,2839870
2348,2024-05-13,1,3,2348000,493080,2841080
2349,2022-08-12,3,1,2349000,493290,2842290
2350,2020-01-22,1,1,2350000,493500,2843500
2351,2022-08-23,3,3,2351000,493710,2844710
2352,2022-12-21,2,1,2352000,493920,2845920
2353,2020-04-16,3,3,2353000,494130,2847130
2354,2021-11-10,2,1,2354000,494340,2848340
2355,2021-04-09,1,1,2355000,494550,2849550
2356,2024-08-28,1,3,2356000,494760,2850760
2357,2020-01-11,1,3,2357000,494970,2851970
2358,2022-05-16,1,3,2358000,495180,2853180
2359,2020-05-31,2,1,2359000,495390,2854390
2360,2022-11-07,2,2,2360000,495600,2855600
2361,2024-02-01,1,2,2361000,495810,2856810
2362,2022-06-09,2,3,2362000,496020,2858020
2363,2022-08-23,2,1,2363000,496230,2859230
2364,2024-04-17,2,2,2364000,496440,2860440
2365,2022-06-03,2,1,2365000,496650,2861650
2366,2024-02-17,1,3,2366000,496860,2862860
2367,2024-05-01,2,2,2367000,497070,2864070
2368,2023-08-08,2,2,2368000,497280,2865280
2369,2020-08-09,1,2,2369000,497490,2866490
2370,2020-08-01,2,3,2370000,497700,2867700
2371,2024-02-17,3,3,2371000,497910,2868910
2372,2020-12-21,3,1,2372000,498120,2870120
2373,2024-10-29,3,1,2373000,498330,2871330
2374,2022-05-14,1,1,2374000,498540,2872540
2375,2021-06-12,3,2,2375000,498750,2873750
2376,2020-12-07,3,3,2376000,498960,2874960
2377,2022-04-11,1,1,2377000,499170,2876170
2378,2024-07-30,3,1,2378000,499380,2877380
2379,2023-09-01,1,1,2379000,499590,2878590
2380,2023-10-25,2,1,2380000,499800,2879800
2381,2022-12-13,1,1,2381000,500010,2881010
2382,2020-10-11,3,3,2382000,500220,2882220
2383,2024-01-29,1,2,2383000,500430,2883430
2384,2022-09-11,1,2,2384000,500640,2884640
2385,2022-04-01,2,3,2385000,500850,2885850
2386,2021-04-13,3,2,2386000,501060,2887060
2387,2021-03-17,1,3,2387000,501270,2888270
2388,2022-03-25,3,3,2388000,501480,2889480
2389,2024-07-13,2,1,2389000,501690,2890690
2390,2021-03-26,2,3,2390000,501900,2891900
2391,2023-03-24,3,3,2391000,502110,2893110
2392,2021-01-08,3,2,2392000,502320,2894320
2393,2022-07-02,3,3,2393000,502530,2895530
2394,2022-02-09,2,3,2394000,502740,2896740
2395,2024-06-01,1,1,2395000,502950,2897950
2396,2020-03-15,2,2,2396000,503160,2899160
2397,2020-06-03,2,1,2397000,503370,2900370
2398,2021-09-02,1,2,2398000,503580,2901580
2399,2021-10-29,3,1,2399000,503790,2902790
2400,2024-12-25,3,1,2400000,504000,2904000
2401,2021-06-27,3,2,2401000,504210,2905210
2402,2020-05-04,1,3,2402000,504420,2906420
2403,2022-05-20,1,2,2403000,504630,2907630
2404,2024-05-07,2,2,2404000,504840,2908840
2405,2022-03-16,2,1,2405000,505050,2910050
2406,2022-02-21,3,3,2406000,505260,2911260
2407,2024-10-26,2,3,2407000,505470,2912470
2408,2024-05-22,2,1,2408000,505680,2913680
2409,2024-06-13,1,1,2409000,505890,2914890
2410,2024-12-02,2,1,2410000,506100,2916100
2411,2020-06-08,1,3,2411000,506310,2917310
2412,2021-12-12,3,2,2412000,506520,2918520
2413,2020-05-16,2,2,2413000,506730,2919730
2414,2023-06-16,2,3,2414000,506940,2920940
2415,2023-06-20,2,2,2415000,507150,2922150
2416,2023-08-01,1,2,2416000,507360,2923360
2417,2021-06-05,3,2,2417000,507570,2924570
2418,2022-03-24,1,2,2418000,507780,2925780
2419,2022-02-19,2,1,2419000,507990,2926990
2420,2021-02-24,3,2,2420000,508200,2928200
2421,2024-06-15,2,2,2421000,508410,2929410
2422,2020-11-13,1,2,2422000,508620,2930620
2423,2022-10-31,1,2,2423000,508830,2931830
2424,2020-03-28,2,2,2424000,509040,2933040
2425,2020-11-14,1,1,2425000,509250,2934250
2426,2024-04-15,1,1,2426000,509460,2935460
2427,2024-01-11,1,1,2427000,509670,2936670
2428,2021-11-18,2,1,2428000,509880,2937880
2429,2024-05-10,3,2,2429000,510090,2939090
2430,2020-11-30,1,1,2430000,510300,2940300
2431,2022-07-25,2,1,2431000,510510,2941510
2432,2021-08-15,1,3,2432000,510720,2942720
2433,2024-01-12,3,3,2433000,510930,2943930
2434,2024-05-09,3,2,2434000,511140,2945140
2435,2021-03-10,3,2,2435000,511350,2946350
2436,2024-01-09,3,1,2436000,511560,2947560
2437,2021-05-25,3,3,2437000,511770,2948770
2438,2020-04-20,3,1,2438000,511980,2949980
2439,2023-12-09,1,3,2439000,512190,2951190
2440,2020-05-26,2,2,2440000,512400,2952400
2441,2020-07-23,1,2,2441000,512610,2953610
2442,2021-03-30,2,2,2442000,512820,2954820
2443,2022-07-15,1,2,2443000,513030,2956030
2444,2021-11-16,2,1,2444000,513240,2957240
2445,2021-09-07,2,2,2445000,513450,2958450
2446,2024-03-12,1,3,2446000,513660,2959660
2447,2021-02-16,1,2,2447000,513870,2960870
2448,2021-06-07,3,1,2448000,514080,2962080
2449,2024-06-23,1,3,2449000,514290,2963290
2450,2021-07-01,3,1,2450000,514500,2964500
2451,2020-12-04,2,2,2451000,514710,2965710
2452,2024-04-05,1,2,2452000,514920,2966920
2453,2021-11-03,2,3,2453000,515130,2968130
2454,2022-08-12,2,1,2454000,515340,2969340
2455,2023-07-24,2,1,2455000,515550,2970550
2456,2020-04-28,3,2,2456000,515760,2971760
2457,2022-05-30,2,3,2457000,515970,2972970
2458,2023-06-28,3,3,2458000,516180,2974180
2459,2020-01-03,2,2,2459000,516390,2975390
2460,2020-12-20,1,3,2460000,516600,2976600
2461,2021-04-16,1,3,2461000,516810,2977810
2462,2020-06-22,2,3,2462000,517020,2979020
2463,2024-01-10,2,1,2463000,517230,2980230
2464,2022-06-22,3,1,2464000,517440,2981440
2465,2024-06-06,1,2,2465000,517650,2982650
2466,2020-02-05,1,1,2466000,517860,2983860
2467,2020-06-22,1,1,2467000,518070,2985070
2468,2020-09-03,2,2,2468000,518280,2986280
2469,2021-10-19,2,2,2469000,518490,2987490
2470,2022-08-11,3,3,2470000,518700,2988700
2471,2021-05-19,3,1,2471000,518910,2989910
2472,2024-02-07,1,1,2472000,519120,2991120
2473,2023-02-16,1,1,2473000,519330,2992330
2474,2023-02-27,2,2,2474000,519540,2993540
2475,2020-04-17,1,1,2475000,519750,2994750
2476,2020-06-11,2,2,2476000,519960,2995960
2477,2023-05-07,2,1,2477000,520170,2997170
2478,2020-12-08,1,3,2478000,520380,2998380
2479,2021-09-21,3,1,2479000,520590,2999590
2480,2020-04-28,2,1,2480000,520800,3000800
2481,2024-12-24,3,3,2481000,521010,3002010
2482,2022-06-06,3,1,2482000,521220,3003220
2483,2023-10-04,1,3,2483000,521430,3004430
2484,2020-11-03,3,3,2484000,521640,3005640
2485,2022-02-22,2,2,2485000,521850,3006850
2486,2024-12-02,2,3,2486000,522060,3008060
2487,2024-05-14,2,3,2487000,522270,3009270
2488,2020-01-07,3,2,2488000,522480,3010480
2489,2020-02-24,1,3,2489000,522690,3011690
2490,2021-09-19,3,1,2490000,522900,3012900
2491,2024-11-06,1,2,2491000,523110,3014110
2492,2021-05-18,1,3,2492000,523320,3015320
2493,2021-09-01,2,1,2493000,523530,3016530
2494,2024-05-05,2,1,2494000,523740,3017740
2495,2022-12-22,1,1,2495000,523950,3018950
2496,2023-03-05,2,3,2496000,524160,3020160
2497,2023-06-18,3,2,2497000,524370,3021370
2498,2024-01-14,2,1,2498000,524580,3022580
2499,2020-04-11,3,1,2499000,524790,3023790
2500,2023-05-03,3,1,2500000,525000,3025000
2501,2024-08-12,1,2,2501000,525210,3026210
2502,2021-11-17,1,3,2502000,525420,3027420
2503,2020-08-27,1,3,2503000,525630,3028630
2504,2020-07-27,1,2,2504000,525840,3029840
2505,2024-02-19,3,1,2505000,526050,3031050
2506,2023-10-30,2,3,2506000,526260,3032260
2507,2020-02-20,1,1,2507000,526470,3033470
2508,2021-08-17,1,1,2508000,526680,3034680
2509,2021-09-18,1,1,2509000,526890,3035890
2510,2021-04-29,1,3,2510000,527100,3037100
2511,2023-07-21,2,3,2511000,527310,3038310
2512,2021-07-04,3,3,2512000,527520,3039520
2513,2023-02-05,3,3,2513000,527730,3040730
2514,2024-12-18,2,3,2514000,527940,3041940
2515,2020-04-12,3,2,2515000,528150,3043150
2516,2021-02-12,2,1,2516000,528360,3044360
2517,2023-02-27,1,3,2517000,528570,3045570
2518,2023-03-12,3,3,2518000,528780,3046780
2519,2024-04-03,3,3,2519000,528990,3047990
2520,2022-04-23,2,3,2520000,529200,3049200
2521,2021-06-08,3,1,2521000,529410,3050410
2522,2023-05-02,1,2,2522000,529620,3051620
2523,2021-08-02,1,1,2523000,529830,3052830
2524,2020-05-09,3,3,2524000,530040,3054040
2525,2023-09-01,3,3,2525000,530250,3055250
2526,2023-12-08,1,1,2526000,530460,3056460
2527,2021-11-11,3,3,2527000,530670,3057670
2528,2024-06-07,1,3,2528000,530880,3058880
2529,2023-04-08,1,3,2529000,531090,3060090
2530,2021-07-16,1,1,2530000,531300,3061300
2531,2022-12-26,2,2,2531000,531510,3062510
2532,2023-10-24,3,3,2532000,531720,3063720
2533,2020-01-20,2,2,2533000,531930,3064930
2534,2020-05-17,2,2,2534000,532140,3066140
2535,2020-05-01,1,3,2535000,532350,3067350
2536,2020-09-02,3,3,2536000,532560,3068560
2537,2020-11-12,1,1,2537000,532770,3069770
2538,2024-05-30,1,2,2538000,532980,3070980
2539,2022-06-28,3,3,2539000,533190,3072190
2540,2022-09-05,2,1,2540000,533400,3073400
2541,2023-08-04,1,1,2541000,533610,3074610
2542,2024-09-16,1,2,2542000,533820,3075820
2543,2020-04-23,2,1,2543000,534030,3077030
2544,2024-02-27,3,1,2544000,534240,3078240
2545,2024-02-17,1,2,2545000,534450,3079450
2546,2023-02-20,1,3,2546000,534660,3080660
2547,2021-11-07,2,2,2547000,534870,3081870
2548,2020-09-22,3,2,2548000,535080,3083080
2549,2020-10-25,2,1,2549000,535290,3084290
2550,2020-06-17,2,1,2550000,535500,3085500
2551,2024-08-18,1,3,2551000,535710,3086710
2552,2020-01-21,1,3,2552000,535920,3087920
2553,2024-11-12,1,3,2553000,536130,3089130
2554,2021-12-05,1,2,2554000,536340,3090340
2555,2023-05-21,1,2,2555000,536550,3091550
2556,2023-12-28,2,3,2556000,536760,3092760
2557,2020-04-06,1,2,2557000,536970,3093970
2558,2021-02-25,3,1,2558000,537180,3095180
2559,2020-05-02,2,3,2559000,537390,3096390
2560,2020-01-15,1,3,2560000,537600,3097600
2561,2021-11-20,1,1,2561000,537810,3098810
2562,2022-01-13,1,2,2562000,538020,3100020
2563,2023-03-02,1,3,2563000,538230,3101230
2564,2023-12-13,3,3,2564000,538440,3102440
2565,2022-10-06,1,1,2565000,538650,3103650
2566,2022-07-29,1,2,2566000,538860,3104860
2567,2024-05-29,3,2,2567000,539070,3106070
2568,2020-07-09,3,2,2568000,539280,3107280
2569,2024-11-07,3,1,2569000,539490,3108490
2570,2023-11-08,2,2,2570000,539700,3109700
2571,2023-01-23,2,2,2571000,539910,3110910
2572,2024-03-26,3,1,2572000,540120,3112120
2573,2020-05-20,1,1,2573000,540330,3113330
2574,2022-06-25,1,2,2574000,540540,3114540
2575,2022-09-27,1,1,2575000,540750,3115750
2576,2021-02-26,1,1,2576000,540960,3116960
2577,2021-11-04,3,1,2577000,541170,3118170
2578,2020-01-21,1,2,2578000,541380,3119380
2579,2024-08-10,2,3,2579000,541590,3120590
2580,2020-08-14,1,1,2580000,541800,3121800
2581,2020-10-20,1,2,2581000,542010,3123010
2582,2020-05-06,1,1,2582000,542220,3124220
2583,2022-02-27,2,2,2583000,542430,3125430
2584,2021-09-21,2,3,2584000,542640,3126640
2585,2020-08-16,2,3,2585000,542850,3127850
2586,2021-10-02,2,3,2586000,543060,3129060
2587,2023-08-08,1,3,2587000,543270,3130270
2588,2024-10-15,1,3,2588000,543480,3131480
2589,2024-03-03,3,2,2589000,543690,3132690
2590,2020-12-18,3,2,2590000,543900,3133900
2591,2020-04-10,1,1,2591000,544110,3135110
2592,2024-09-11,2,1,2592000,544320,3136320
2593,2023-03-21,3,2,2593000,544530,3137530
2594,2024-03-06,3,3,2594000,544740,3138740
2595,2024-03-07,1,2,2595000,544950,3139950
2596,2022-10-24,2,3,2596000,545160,3141160
2597,2023-05-22,1,3,2597000,545370,3142370
2598,2022-07-28,3,2,2598000,545580,3143580
2599,2020-11-26,2,2,2599000,545790,3144790
2600,2022-03-04,2,3,2600000,546000,3146000
2601,2024-06-28,2,3,2601000,546210,3147210
2602,2020-02-11,1,1,2602000,546420,3148420
2603,2023-04-27,1,1,2603000,546630,3149630
2604,2020-02-08,3,1,2604000,546840,3150840
2605,2023-12-23,3,2,2605000,547050,3152050
2606,2020-08-22,1,2,2606000,547260,3153260
2607,2021-05-13,3,1,2607000,547470,3154470
2608,2023-11-12,1,3,2608000,547680,3155680
2609,2022-01-15,1,1,2609000,547890,3156890
2610,2022-04-24,3,1,2610000,548100,3158100
2611,2022-03-24,3,3,2611000,548310,3159310
2612,2020-11-16,3,1,2612000,548520,3160520
2613,2021-05-19,3,2,2613000,548730,3161730
2614,2024-07-12,3,3,2614000,548940,3162940
2615,2022-07-07,3,2,2615000,549150,3164150
2616,2020-12-31,2,3,2616000,549360,3165360
2617,2024-05-12,1,1,2617000,549570,3166570
2618,2021-07-22,1,1,2618000,549780,3167780
2619,2020-08-23,1,1,2619000,549990,3168990
2620,2022-04-19,3,3,2620000,550200,3170200
2621,2023-11-30,3,2,2621000,550410,3171410
2622,2024-08-30,2,2,2622000,550620,3172620
2623,2021-11-10,2,2,2623000,550830,3173830
2624,2022-10-23,1,2,2624000,551040,3175040
2625,2022-03-11,3,1,2625000,551250,3176250
2626,2023-10-30,1,2,2626000,551460,3177460
2627,2021-11-14,1,2,2627000,551670,3178670
2628,2022-03-16,1,3,2628000,551880,3179880
2629,2022-09-27,3,2,2629000,552090,3181090
2630,2024-09-12,2,1,2630000,552300,3182300
2631,2021-01-14,3,1,2631000,552510,3183510
2632,2021-10-07,2,3,2632000,552720,3184720
2633,2024-08-09,2,3,2633000,552930,3185930
2634,2020-12-27,3,3,2634000,553140,3187140
2635,2022-04-29,3,3,2635000,553350,3188350
2636,2023-03-05,2,2,2636000,553560,3189560
2637,2024-07-20,3,3,2637000,553770,3190770
2638,2024-01-18,1,1,2638000,553980,3191980
2639,2021-08-20,1,2,2639000,554190,3193190
2640,2021-02-01,1,2,2640000,554400,3194400
2641,2020-04-20,2,2,2641000,554610,3195610
2642,2020-01-17,1,1,2642000,554820,3196820
2643,2022-08-25,3,3,2643000,555030,3198030
2644,2023-11-20,2,2,2644000,555240,3199240
2645,2024-01-17,2,2,2645000,555450,3200450
2646,2024-12-13,3,3,2646000,555660,3201660
2647,2024-01-16,1,2,2647000,555870,3202870
2648,2022-11-24,2,1,2648000,556080,3204080
2649,2024-07-28,2,2,2649000,556290,3205290
2650,2023-11-10,3,1,2650000,556500,3206500
2651,2023-06-30,1,1,2651000,556710,3207710
2652,2023-03-14,2,3,2652000,556920,3208920
2653,2023-09-16,2,3,2653000,557130,3210130
2654,2024-05-09,3,1,2654000,557340,3211340
2655,2024-04-07,3,3,2655000,557550,3212550
2656,2024-01-05,3,1,2656000,557760,3213760
2657,2023-07-29,3,3,2657000,557970,3214970
2658,2021-10-08,3,3,2658000,558180,3216180
2659,2020-01-22,3,1,2659000,558390,3217390
2660,2021-09-29,2,2,2660000,558600,3218600
2661,2020-12-03,3,2,2661000,558810,3219810
2662,2024-09-02,2,2,2662000,559020,3221020
2663,2020-09-03,2,2,2663000,559230,3222230
2664,2021-04-22,3,2,2664000,559440,3223440
2665,2024-07-05,2,1,2665000,559650,3224650
2666,2021-09-16,1,2,2666000,559860,3225860
2667,2022-07-17,1,3,2667000,560070,3227070
2668,2021-09-06,3,2,2668000,560280,3228280
2669,2023-06-18,3,3,2669000,560490,3229490
2670,2022-11-23,2,3,2670000,560700,3230700
2671,2020-02-23,1,2,2671000,560910,3231910
2672,2022-06-05,3,3,2672000,561120,3233120
2673,2022-11-27,2,2,2673000,561330,3234330
2674,2024-01-03,1,3,2674000,561540,3235540
2675,2023-01-17,1,2,2675000,561750,3236750
2676,2022-02-23,1,1,2676000,561960,3237960
2677,2022-11-07,1,2,2677000,562170,3239170
2678,2021-12-15,2,3,2678000,562380,3240380
2679,2022-06-02,1,3,2679000,562590,3241590
2680,2023-03-25,1,2,2680000,562800,3242800
2681,2020-10-04,1,3,2681000,563010,3244010
2682,2022-01-29,3,1,2682000,563220,3245220
2683,2020-05-29,2,2,2683000,563430,3246430
2684,2024-08-25,3,2,2684000,563640,3247640
2685,2020-05-01,3,2,2685000,563850,3248850
2686,2022-09-03,1,3,2686000,564060,3250060
2687,2024-12-15,1,1,2687000,564270,3251270
2688,2024-06-09,1,2,2688000,564480,3252480
2689,2024-08-20,2,1,2689000,564690,3253690
2690,2020-02-08,2,1,2690000,564900,3254900
2691,2023-04-04,2,1,2691000,565110,3256110
2692,2024-05-09,3,1,2692000,565320,3257320
2693,2022-12-23,2,2,2693000,565530,3258530
2694,2022-11-15,3,3,2694000,565740,3259740
2695,2024-01-02,1,2,2695000,565950,3260950
2696,2022-09-14,1,2,2696000,566160,3262160
2697,2023-04-05,2,1,2697000,566370,3263370
2698,2021-06-14,3,1,2698000,566580,3264580
2699,2022-10-25,2,3,2699000,566790,3265790
2700,2023-04-30,3,1,2700000,567000,3267000
2701,2022-07-14,3,3,2701000,567210,3268210
2702,2021-02-12,2,1,2702000,567420,3269420
2703,2020-01-01,2,1,2703000,567630,3270630
2704,2021-06-15,3,3,2704000,567840,3271840
2705,2023-05-29,3,1,2705000,568050,3273050
2706,2020-07-08,2,3,2706000,568260,3274260
2707,2024-10-08,3,2,2707000,568470,3275470
2708,2020-10-11,3,1,2708000,568680,3276680
2709,2021-11-29,1,3,2709000,568890,3277890
2710,2021-02-11,3,1,2710000,569100,3279100
2711,2022-02-19,1,3,2711000,569310,3280310
2712,2023-12-22,3,1,2712000,569520,3281520
2713,2020-10-14,2,3,2713000,569730,3282730
2714,2020-01-31,1,1,2714000,569940,3283940
2715,2021-06-27,1,1,2715000,570150,3285150
2716,2022-07-02,2,2,2716000,570360,3286360
2717,2022-01-31,2,1,2717000,570570,3287570
2718,2023-02-13,2,2,2718000,570780,3288780
2719,2020-01-17,3,2,2719000,570990,3289990
2720,2024-02-16,1,3,2720000,571200,3291200
2721,2021-03-16,1,1,2721000,571410,3292410
2722,2024-10-13,3,3,2722000,571620,3293620
2723,2022-11-27,3,3,2723000,571830,3294830
2724,2021-07-11,3,3,2724000,572040,3296040
2725,2020-04-18,3,3,2725000,572250,3297250
2726,2024-10-16,2,1,2726000,572460,3298460
2727,2020-01-27,3,2,2727000,572670,3299670
2728,2022-11-25,1,3,2728000,572880,3300880
2729,2024-02-07,3,2,2729000,573090,3302090
2730,2024-02-15,1,3,2730000,573300,3303300
2731,2023-08-10,2,1,2731000,573510,3304510
2732,2021-05-28,2,3,2732000,573720,3305720
2733,2022-10-10,2,3,2733000,573930,3306930
2734,2023-05-30,2,2,2734000,574140,3308140
2735,2021-03-16,2,1,2735000,574350,3309350
2736,2024-02-08,3,3,2736000,574560,3310560
2737,2020-02-26,3,3,2737000,574770,3311770
2738,2022-06-08,2,2,2738000,574980,3312980
2739,2021-12-21,1,2,2739000,575190,3314190
2740,2021-03-27,3,3,2740000,575400,3315400
2741,2024-07-07,1,2,2741000,575610,3316610
2742,2020-05-10,1,3,2742000,575820,3317820
2743,2023-06-22,2,3,2743000,576030,3319030
2744,2022-05-10,2,3,2744000,576240,3320240
2745,2021-05-04,1,3,2745000,576450,3321450
2746,2024-11-15,2,1,2746000,576660,3322660
2747,2021-01-24,1,3,2747000,576870,3323870
2748,2020-01-09,3,1,2748000,577080,3325080
2749,2020-01-17,1,2,2749000,577290,3326290
2750,2021-01-22,1,2,2750000,577500,3327500
2751,2022-10-27,1,2,2751000,577710,3328710
2752,2024-05-03,3,2,2752000,577920,3329920
2753,2022-04-10,3,3,2753000,578130,3331130
2754,2024-11-23,3,3,2754000,578340,3332340
2755,2023-05-01,1,1,2755000,578550,3333550
2756,2021-08-13,3,3,2756000,578760,3334760
2757,2022-03-15,1,2,2757000,578970,3335970
2758,2024-04-05,3,1,2758000,579180,3337180
2759,2022-07-27,1,3,2759000,579390,3338390
2760,2020-04-18,1,3,2760000,579600,3339600
2761,2024-03-06,1,2,2761000,579810,3340810
2762,2022-12-06,1,1,2762000,580020,3342020
2763,2020-07-04,1,3,2763000,580230,3343230
2764,2020-02-15,3,3,2764000,580440,3344440
2765,2021-04-24,1,1,2765000,580650,3345650
2766,2021-07-10,1,1,2766000,580860,3346860
2767,2023-12-09,2,3,2767000,581070,3348070
2768,2022-11-12,2,2,2768000,581280,3349280
2769,2022-06-24,2,2,2769000,581490,3350490
2770,2020-10-20,1,3,2770000,581700,3351700
2771,2022-03-19,3,3,2771000,581910,3352910
2772,2020-01-24,3,1,2772000,582120,3354120
2773,2023-05-06,3,1,2773000,582330,3355330
2774,2020-09-13,2,3,2774000,582540,3356540
2775,2023-12-08,2,2,2775000,582750,3357750
2776,2023-06-06,1,3,2776000,582960,3358960
2777,2021-01-21,3,2,2777000,583170,3360170
2778,2023-02-24,3,3,2778000,583380,3361380
2779,2024-12-19,3,3,2779000,583590,3362590
2780,2021-12-25,1,3,2780000,583800,3363800
2781,2022-08-01,3,2,2781000,584010,3365010
2782,2020-07-08,2,2,2782000,584220,3366220
2783,2022-06-24,2,3,2783000,584430,3367430
2784,2024-10-29,2,2,2784000,584640,3368640
2785,2021-06-02,2,2,2785000,584850,3369850
2786,2023-02-15,1,2,2786000,585060,3371060
2787,2020-11-05,3,1,2787000,585270,3372270
2788,2020-08-29,1,1,2788000,585480,3373480
2789,2022-12-27,3,3,2789000,585690,3374690
2790,2021-09-15,1,2,2790000,585900,3375900
2791,2022-04-04,1,3,2791000,586110,3377110
2792,2021-11-09,2,1,2792000,586320,3378320
2793,2024-06-08,2,3,2793000,586530,3379530
2794,2024-07-11,2,2,2794000,586740,3380740
2795,2024-12-15,2,2,2795000,586950,3381950
2796,2023-12-12,1,2,2796000,587160,3383160
2797,2023-07-23,1,1,2797000,587370,3384370
2798,2023-06-17,3,1,2798000,587580,3385580
2799,2024-03-27,1,3,2799000,587790,3386790
2800,2020-10-23,2,1,2800000,588000,3388000
2801,2023-02-13,2,2,2801000,588210,3389210
2802,2023-09-25,2,1,2802000,588420,3390420
2803,2022-12-24,1,2,2803000,588630,3391630
2804,2023-12-01,2,1,2804000,588840,3392840
2805,2020-12-24,3,1,2805000,589050,3394050
2806,2022-04-30,3,2,2806000,589260,3395260
2807,2021-12-16,1,2,2807000,589470,3396470
2808,2024-01-09,3,1,2808000,589680,3397680
2809,2024-09-12,3,1,2809000,589890,3398890
2810,2020-01-23,3,2,2810000,590100,3400100
2811,2021-01-24,2,2,2811000,590310,3401310
2812,2023-02-11,3,2,2812000,590520,3402520
2813,2024-02-24,2,1,2813000,590730,3403730
2814,2023-10-20,2,3,2814000,590940,3404940
2815,2022-11-16,1,3,2815000,591150,3406150
2816,2023-09-13,3,1,2816000,591360,3407360
2817,2020-01-29,3,1,2817000,591570,3408570
2818,2020-04-26,2,3,2818000,591780,3409780
2819,2024-11-29,2,1,2819000,591990,3410990
2820,2023-11-12,3,1,2820000,592200,3412200
2821,2021-11-17,3,3,2821000,592410,3413410
2822,2024-12-15,1,3,2822000,592620,3414620
2823,2021-08-06,2,3,2823000,592830,3415830
2824,2023-09-08,1,1,2824000,593040,3417040
2825,2022-11-16,3,1,2825000,593250,3418250
2826,2020-02-09,1,1,2826000,593460,3419460
2827,2022-12-02,2,3,2827000,593670,3420670
2828,2022-05-16,3,2,2828000,593880,3421880
2829,2022-11-29,2,1,2829000,594090,3423090
2830,2021-07-05,3,3,2830000,594300,3424300
2831,2024-05-20,2,3,2831000,594510,3425510
2832,2024-06-22,3,3,2832000,594720,3426720
2833,2024-01-08,2,3,2833000,594930,3427930
2834,2024-07-17,3,1,2834000,595140,3429140
2835,2024-11-04,1,2,2835000,595350,3430350
2836,2020-01-22,1,3,2836000,595560,3431560
2837,2023-01-23,2,2,2837000,595770,3432770
2838,2024-10-20,2,2,2838000,595980,3433980
2839,2024-09-16,1,3,2839000,596190,3435190
2840,2022-11-18,1,2,2840000,596400,3436400
2841,2023-10-30,3,3,2841000,596610,3437610
2842,2023-03-08,2,2,2842000,596820,3438820
2843,2021-05-18,1,3,2843000,597030,3440030
2844,2021-05-14,3,1,2844000,597240,3441240
2845,2022-11-18,2,1,2845000,597450,3442450
2846,2022-12-04,1,1,2846000,597660,3443660
2847,2021-09-12,2,1,2847000,597870,3444870
2848,2021-07-26,1,2,2848000,598080,3446080
2849,2021-12-08,3,1,2849000,598290,3447290
2850,2023-05-26,2,2,2850000,598500,3448500
2851,2024-01-03,2,2,2851000,598710,3449710
2852,2023-02-16,2,3,2852000,598920,3450920
2853,2023-09-27,3,2,2853000,599130,3452130
2854,2024-02-16,2,3,2854000,599340,3453340
2855,2023-03-31,2,2,2855000,599550,3454550
2856,2022-03-21,1,3,2856000,599760,3455760
2857,2020-04-04,3,3,2857000,599970,3456970
2858,2020-05-10,3,3,2858000,600180,3458180
2859,2022-10-21,3,2,2859000,600390,3459390
2860,2024-04-22,1,3,2860000,600600,3460600
2861,2023-02-22,3,1,2861000,600810,3461810
2862,2024-12-11,3,2,2862000,601020,3463020
2863,2022-08-24,1,2,2863000,601230,3464230
2864,2023-03-17,3,2,2864000,601440,3465440
2865,2022-09-03,2,2,2865000,601650,3466650
2866,2021-01-31,1,1,2866000,601860,3467860
2867,2023-06-15,3,2,2867000,602070,3469070
2868,2022-05-21,3,2,2868000,602280,3470280
2869,2024-03-09,2,1,2869000,602490,3471490
2870,2022-08-29,2,1,2870000,602700,3472700
2871,2021-08-20,3,2,2871000,602910,3473910
2872,2021-09-27,1,2,2872000,603120,3475120
2873,2022-06-19,2,1,2873000,603330,3476330
2874,2022-12-09,3,1,2874000,603540,3477540
2875,2021-08-09,1,2,2875000,603750,3478750
2876,2022-03-19,1,3,2876000,603960,3479960
2877,2021-05-03,3,3,2877000,604170,3481170
2878,2020-10-22,2,2,2878000,604380,3482380
2879,2022-04-01,3,2,2879000,604590,3483590
2880,2022-11-14,3,3,2880000,604800,3484800
2881,2023-02-06,3,3,2881000,605010,3486010
2882,2024-04-06,3,1,2882000,605220,3487220
2883,2022-11-09,1,1,2883000,605430,3488430
2884,2024-04-24,1,1,2884000,605640,3489640
2885,2024-09-01,3,3,2885000,605850,3490850
2886,2022-01-05,2,2,2886000,606060,3492060
2887,2024-02-01,2,3,2887000,606270,3493270
2888,2021-12-06,1,3,2888000,606480,3494480
2889,2024-01-04,3,3,2889000,606690,3495690
2890,2023-10-19,1,3,2890000,606900,3496900
2891,2024-06-13,1,2,2891000,607110,3498110
2892,2021-02-20,1,1,2892000,607320,3499320
2893,2022-06-09,1,2,2893000,607530,3500530
2894,2022-06-21,1,1,2894000,607740,3501740
2895,2020-06-15,1,2,2895000,607950,3502950
2896,2024-02-03,1,3,2896000,608160,3504160
2897,2020-03-08,3,3,2897000,608370,3505370
2898,2021-10-16,2,2,2898000,608580,3506580
2899,2022-07-07,2,2,2899000,608790,3507790
2900,2023-07-26,1,3,2900000,609000,3509000
2901,2021-01-21,1,1,2901000,609210,3510210
2902,2024-10-09,2,1,2902000,609420,3511420
2903,2024-11-04,1,3,2903000,609630,3512630
2904,2022-09-07,1,1,2904000,609840,3513840
2905,2024-07-14,1,1,2905000,610050,3515050
2906,2021-07-04,1,2,2906000,610260,3516260
2907,2021-03-19,2,1,2907000,610470,3517470
2908,2020-06-20,3,2,2908000,610680,3518680
2909,2024-05-12,2,3,2909000,610890,3519890
2910,2024-06-04,3,3,2910000,611100,3521100
2911,2024-12-15,1,1,2911000,611310,3522310
2912,2023-04-04,3,1,2912000,611520,3523520
2913,2020-06-19,3,2,2913000,611730,3524730
2914,2024-08-26,3,2,2914000,611940,3525940
2915,2021-12-15,2,2,2915000,612150,3527150
2916,2022-06-28,1,1,2916000,612360,3528360
2917,2020-03-05,2,1,2917000,612570,3529570
2918,2024-03-16,3,2,2918000,612780,3530780
2919,2023-03-30,1,2,2919000,612990,3531990
2920,2024-12-19,2,1,2920000,613200,3533200
2921,2024-09-27,1,3,2921000,613410,3534410
2922,2020-12-11,2,3,2922000,613620,3535620
2923,2022-11-02,2,1,2923000,613830,3536830
2924,2022-07-09,3,2,2924000,614040,3538040
2925,2024-05-06,1,2,2925000,614250,3539250
2926,2024-12-21,1,1,2926000,614460,3540460
2927,2020-01-10,1,2,2927000,614670,3541670
2928,2021-02-09,2,2,2928000,614880,3542880
2929,2021-09-01,1,2,2929000,615090,3544090
2930,2022-04-17,2,3,2930000,615300,3545300
2931,2024-08-04,1,3,2931000,615510,3546510
2932,2023-01-31,2,3,2932000,615720,3547720
2933,2022-02-11,3,2,2933000,615930,3548930
2934,2022-04-29,1,3,2934000,616140,3550140
2935,2023-07-08,3,2,2935000,616350,3551350
2936,2020-12-23,1,1,2936000,616560,3552560
2937,2020-05-05,1,3,2937000,616770,3553770
2938,2021-09-17,3,1,2938000,616980,3554980
2939,2021-07-14,3,2,2939000,617190,3556190
2940,2022-12-21,2,1,2940000,617400,3557400
2941,2024-10-03,1,2,2941000,617610,3558610
2942,2023-02-27,1,2,2942000,617820,3559820
2943,2022-08-06,1,2,2943000,618030,3561030
2944,2022-04-23,2,2,2944000,618240,3562240
2945,2020-01-15,3,2,2945000,618450,3563450
2946,2021-06-18,3,3,2946000,618660,3564660
2947,2021-07-30,2,1,2947000,618870,3565870
2948,2021-02-12,3,1,2948000,619080,3567080
2949,2020-08-04,3,2,2949000,619290,3568290
2950,2022-08-01,3,3,2950000,619500,3569500
2951,2024-03-04,2,3,2951000,619710,3570710
2952,2023-01-14,3,1,2952000,619920,3571920
2953,2021-03-21,1,2,2953000,620130,3573130
2954,2020-04-14,3,1,2954000,620340,3574340
2955,2020-10-13,1,3,2955000,620550,3575550
2956,2023-11-17,3,1,2956000,620760,3576760
2957,2023-03-24,2,1,2957000,620970,3577970
2958,2021-03-26,2,2,2958000,621180,3579180
2959,2022-11-20,2,3,2959000,621390,3580390
2960,2024-05-27,1,2,2960000,621600,3581600
2961,2022-08-24,2,2,2961000,621810,3582810
2962,2021-09-18,1,2,2962000,622020,3584020
2963,2022-08-18,2,1,2963000,622230,3585230
2964,2024-02-29,3,3,2964000,622440,3586440
2965,2022-06-14,3,3,2965000,622650,3587650
2966,2021-02-27,2,2,2966000,622860,3588860
2967,2024-06-04,3,1,2967000,623070,3590070
2968,2022-12-25,2,3,2968000,623280,3591280
2969,2022-04-13,3,3,2969000,623490,3592490
2970,2022-01-21,2,1,2970000,623700,3593700
2971,2022-01-17,1,3,2971000,623910,3594910
2972,2024-08-21,2,1,2972000,624120,3596120
2973,2022-12-24,3,1,2973000,624330,3597330
2974,2023-08-15,1,1,2974000,624540,3598540
2975,2021-08-17,3,3,2975000,624750,3599750
2976,2024-04-05,2,2,2976000,624960,3600960
2977,2024-06-26,1,2,2977000,625170,3602170
2978,2020-12-26,1,2,2978000,625380,3603380
2979,2020-02-04,1,1,2979000,625590,3604590
2980,2022-11-20,2,1,2980000,625800,3605800
2981,2023-08-17,1,1,2981000,626010,3607010
2982,2022-06-09,3,1,2982000,626220,3608220
2983,2020-06-06,3,3,2983000,626430,3609430
2984,2022-03-18,1,1,2984000,626640,3610640
2985,2024-03-28,1,2,2985000,626850,3611850
2986,2020-11-13,2,2,2986000,627060,3613060
2987,2023-01-05,3,1,2987000,627270,3614270
2988,2022-10-03,2,1,2988000,627480,3615480
2989,2024-10-27,2,2,2989000,627690,3616690
2990,2020-07-15,1,3,2990000,627900,3617900
2991,2020-09-28,1,1,2991000,628110,3619110
2992,2024-05-29,2,3,2992000,628320,3620320
2993,2023-06-09,2,1,2993000,628530,3621530
2994,2020-06-17,1,3,2994000,628740,3622740
2995,2020-06-08,3,3,2995000,628950,3623950
2996,2022-12-24,2,2,2996000,629160,3625160
2997,2024-09-28,1,1,2997000,629370,3626370
2998,2020-08-15,3,1,2998000,629580,3627580
2999,2021-05-15,2,1,2999000,629790,3628790
3000,2020-10-26,3,2,3000000,630000,3630000
3001,2021-05-23,2,1,3001000,630210,3631210
3002,2022-07-12,2,3,3002000,630420,3632420
3003,2023-04-24,2,1,3003000,630630,3633630
3004,2024-07-24,1,2,3004000,630840,3634840
3005,2022-03-11,2,1,3005000,631050,3636050
3006,2024-04-09,1,1,3006000,631260,3637260
3007,2020-02-14,2,3,3007000,631470,3638470
3008,2021-11-14,3,2,3008000,631680,3639680
3009,2021-02-19,3,3,3009000,631890,3640890
3010,2020-08-08,1,1,3010000,632100,3642100
3011,2024-12-24,1,1,3011000,632310,3643310
3012,2024-10-20,2,1,3012000,632520,3644520
3013,2022-11-18,1,3,3013000,632730,3645730
3014,2023-08-06,1,3,3014000,632940,3646940
3015,2020-03-03,1,3,3015000,633150,3648150
3016,2024-08-09,1,2,3016000,633360,3649360
3017,2020-10-25,3,2,3017000,633570,3650570
3018,2021-07-15,1,2,3018000,633780,3651780
3019,2020-06-28,3,3,3019000,633990,3652990
3020,2022-03-22,3,3,3020000,634200,3654200
3021,2022-02-22,3,1,3021000,634410,3655410
3022,2022-02-05,1,2,3022000,634620,3656620
3023,2023-03-09,1,1,3023000,634830,3657830
3024,2023-05-23,2,2,3024000,635040,3659040
3025,2024-05-23,1,1,3025000,635250,3660250
3026,2024-08-12,1,2,3026000,635460,3661460
3027,2023-03-22,1,3,3027000,635670,3662670
3028,2023-05-23,3,3,3028000,635880,3663880
3029,2023-05-19,3,3,3029000,636090,3665090
3030,2023-08-07,1,2,3030000,636300,3666300
3031,2020-04-10,3,3,3031000,636510,3667510
3032,2021-12-23,3,3,3032000,636720,3668720
3033,2024-08-13,2,3,3033000,636930,3669930
3034,2020-12-31,2,1,3034000,637140,3671140
3035,2022-07-10,2,3,3035000,637350,3672350
3036,2021-11-01,1,1,3036000,637560,3673560
3037,2020-11-22,2,3,3037000,637770,3674770
3038,2021-05-28,3,1,3038000,637980,3675980
3039,2023-12-30,3,2,3039000,638190,3677190
3040,2024-02-29,3,1,3040000,638400,3678400
3041,2024-04-23,3,3,3041000,638610,3679610
3042,2021-01-01,1,2,3042000,638820,3680820
3043,2022-09-26,2,2,3043000,639030,3682030
3044,2020-12-14,2,3,3044000,639240,3683240
3045,2023-03-28,1,2,3045000,639450,3684450
3046,2021-10-04,1,3,3046000,639660,3685660
3047,2023-06-19,2,1,3047000,639870,3686870
3048,2024-08-18,3,2,3048000,640080,3688080
3049,2020-02-02,3,2,3049000,640290,3689290
3050,2024-06-29,3,1,3050000,640500,3690500
3051,2023-06-05,1,1,3051000,640710,3691710
3052,2024-05-07,2,3,3052000,640920,3692920
3053,2022-01-15,1,3,3053000,641130,3694130
3054,2022-09-04,2,1,3054000,641340,3695340
3055,2023-12-21,3,1,3055000,641550,3696550
3056,2024-05-26,2,3,3056000,641760,3697760
3057,2021-09-01,3,3,3057000,641970,3698970
3058,2022-04-16,3,2,3058000,642180,3700180
3059,2022-04-14,3,1,3059000,642390,3701390
3060,2023-01-05,2,2,3060000,642600,3702600
3061,2021-08-24,3,1,3061000,642810,3703810
3062,2023-07-08,3,2,3062000,643020,3705020
3063,2024-02-28,3,2,3063000,643230,3706230
3064,2022-03-31,3,2,3064000,643440,3707440
3065,2021-12-29,1,3,3065000,643650,3708650
3066,2024-06-08,3,3,3066000,643860,3709860
3067,2023-02-04,1,1,3067000,644070,3711070
3068,2023-01-01,1,3,3068000,644280,3712280
3069,2023-04-24,2,2,3069000,644490,3713490
3070,2021-10-17,3,1,3070000,644700,3714700
3071,2024-09-09,1,3,3071000,644910,3715910
3072,2022-05-15,3,2,3072000,645120,3717120
3073,2024-05-29,1,2,3073000,645330,3718330
3074,2024-04-17,3,2,3074000,645540,3719540
3075,2020-01-27,2,2,3075000,645750,3720750
3076,2020-12-10,3,1,3076000,645960,3721960
3077,2024-09-09,2,1,3077000,646170,3723170
3078,2023-02-25,3,1,3078000,646380,3724380
3079,2022-11-21,1,2,3079000,646590,3725590
3080,2022-11-13,1,1,3080000,646800,3726800
3081,2024-11-25,2,3,3081000,647010,3728010
3082,2024-11-21,1,3,3082000,647220,3729220
3083,2022-03-11,1,3,3083000,647430,3730430
3084,2023-10-28,3,2,3084000,647640,3731640
3085,2021-01-03,2,1,3085000,647850,3732850
3086,2024-06-24,2,3,3086000,648060,3734060
3087,2023-05-08,2,3,3087000,648270,3735270
3088,2024-03-29,2,3,3088000,648480,3736480
3089,2024-06-05,3,3,3089000,648690,3737690
3090,2021-09-02,2,1,3090000,648900,3738900
3091,2024-10-13,1,1,3091000,649110,3740110
3092,2024-12-12,1,1,3092000,649320,3741320
3093,2022-03-17,1,2,3093000,649530,3742530
3094,2021-12-07,3,3,3094000,649740,3743740
3095,2020-07-07,3,3,3095000,649950,3744950
3096,2024-03-15,1,2,3096000,650160,3746160
3097,2020-06-06,1,1,3097000,650370,3747370
3098,2020-04-02,2,3,3098000,650580,3748580
3099,2024-08-23,1,3,3099000,650790,3749790
3100,2022-11-02,1,3,3100000,651000,3751000
3101,2022-02-15,1,3,3101000,651210,3752210
3102,2023-10-06,2,1,3102000,651420,3753420
3103,2023-04-19,2,1,3103000,651630,3754630
3104,2022-09-22,1,3,3104000,651840,3755840
3105,2021-10-01,2,3,3105000,652050,3757050
3106,2021-05-24,3,1,3106000,652260,3758260
3107,2024-08-21,1,3,3107000,652470,3759470
3108,2020-09-10,2,2,3108000,652680,3760680
3109,2021-04-22,3,2,3109000,652890,3761890
3110,2022-02-27,2,3,3110000,653100,3763100
3111,2024-05-28,2,3,3111000,653310,3764310
3112,2024-08-05,3,1,3112000,653520,3765520
3113,2020-02-10,2,3,3113000,653730,3766730
3114,2020-01-08,3,2,3114000,653940,3767940
3115,2020-09-21,3,2,3115000,654150,3769150
3116,2024-05-19,3,1,3116000,654360,3770360
3117,2021-09-01,2,2,3117000,654570,3771570
3118,2021-09-29,1,2,3118000,654780,3772780
3119,2024-04-18,1,1,3119000,654990,3773990
3120,2020-01-13,1,2,3120000,655200,3775200
3121,2020-11-16,2,1,3121000,655410,3776410
3122,2024-03-12,3,1,3122000,655620,3777620
3123,2022-07-24,2,2,3123000,655830,3778830
3124,2024-03-30,3,1,3124000,656040,3780040
3125,2020-01-08,2,1,3125000,656250,3781250
3126,2022-10-08,3,2,3126000,656460,3782460
3127,2020-11-19,1,1,3127000,656670,3783670
3128,2024-01-25,2,3,3128000,656880,3784880
3129,2023-02-03,3,2,3129000,657090,3786090
3130,2020-10-20,2,1,3130000,657300,3787300
3131,2022-06-26,1,1,3131000,657510,3788510
3132,2021-12-27,1,3,3132000,657720,3789720
3133,2023-08-28,3,2,3133000,657930,3790930
3134,2023-08-28,1,1,3134000,658140,3792140
3135,2021-08-23,2,1,3135000,658350,3793350
3136,2022-01-18,2,1,3136000,658560,3794560
3137,2021-03-23,3,2,3137000,658770,3795770
3138,2020-03-11,2,2,3138000,658980,3796980
3139,2022-11-30,2,2,3139000,659190,3798190
3140,2020-08-24,1,1,3140000,659400,3799400
3141,2022-04-19,2,1,3141000,659610,3800610
3142,2023-12-07,3,2,3142000,659820,3801820
3143,2023-05-10,3,3,3143000,660030,3803030
3144,2021-12-21,1,1,3144000,660240,3804240
3145,2022-12-14,2,3,3145000,660450,3805450
3146,2021-04-20,3,2,3146000,660660,3806660
3147,2020-05-13,3,3,3147000,660870,3807870
3148,2024-03-08,2,1,3148000,661080,3809080
3149,2021-06-19,1,3,3149000,661290,3810290
3150,2022-12-30,1,2,3150000,661500,3811500
3151,2021-05-28,2,1,3151000,661710,3812710
3152,2021-07-23,1,1,3152000,661920,3813920
3153,2020-09-04,2,2,3153000,662130,3815130
3154,2022-10-14,2,3,3154000,662340,3816340
3155,2021-03-18,2,3,3155000,662550,3817550
3156,2020-01-04,1,2,3156000,662760,3818760
3157,2024-11-21,2,2,3157000,662970,3819970
3158,2023-05-18,2,1,3158000,663180,3821180
3159,2024-09-23,3,1,3159000,663390,3822390
3160,2023-06-21,3,1,3160000,663600,3823600
3161,2024-10-02,3,1,3161000,663810,3824810
3162,2022-07-30,2,3,3162000,664020,3826020
3163,2023-03-19,1,1,3163000,664230,3827230
3164,2023-09-22,3,1,3164000,664440,3828440
3165,2023-12-01,2,1,3165000,664650,3829650
3166,2020-09-13,1,3,3166000,664860,3830860
3167,2022-10-20,2,3,3167000,665070,3832070
3168,2024-11-23,3,3,3168000,665280,3833280
3169,2022-01-23,3,2,3169000,665490,3834490
3170,2023-12-28,3,3,3170000,665700,3835700
3171,2023-04-20,1,2,3171000,665910,3836910
3172,2024-05-23,2,2,3172000,666120,3838120
3173,2020-10-04,1,1,3173000,666330,3839330
3174,2021-07-09,2,2,3174000,666540,3840540
3175,2022-03-20,3,1,3175000,666750,3841750
3176,2020-01-06,1,3,3176000,666960,3842960
3177,2024-11-24,2,3,3177000,667170,3844170
3178,2024-04-19,3,1,3178000,667380,3845380
3179,2022-10-02,3,1,3179000,667590,3846590
3180,2024-10-25,3,2,3180000,667800,3847800
3181,2024-09-26,2,1,3181000,668010,3849010
3182,2022-07-09,2,2,3182000,668220,3850220
3183,2021-08-14,3,1,3183000,668430,3851430
3184,2024-09-05,3,1,3184000,668640,3852640
3185,2024-01-26,1,1,3185000,668850,3853850
3186,2023-09-03,2,3,3186000,669060,3855060
3187,2022-01-27,1,2,3187000,669270,3856270
3188,2020-01-25,3,1,3188000,669480,3857480
3189,2020-10-18,3,1,3189000,669690,3858690
3190,2020-08-28,3,2,3190000,669900,3859900
3191,2022-03-15,1,3,3191000,670110,3861110
3192,2021-02-14,1,1,3192000,670320,3862320
3193,2024-09-29,2,1,3193000,670530,3863530
3194,2021-06-09,2,1,3194000,670740,3864740
3195,2024-05-07,1,2,3195000,670950,3865950
3196,2021-07-20,2,1,3196000,671160,3867160
3197,2023-11-04,2,3,3197000,671370,3868370
3198,2024-04-17,2,2,3198000,671580,3869580
3199,2024-03-10,3,2,3199000,671790,3870790
3200,2024-08-20,3,1,3200000,672000,3872000
3201,2022-11-16,1,2,3201000,672210,3873210
3202,2022-05-13,1,2,3202000,672420,3874420
3203,2022-05-03,1,1,3203000,672630,3875630
3204,2022-01-04,2,2,3204000,672840,3876840
3205,2021-07-07,1,1,3205000,673050,3878050
3206,2022-08-06,1,2,3206000,673260,3879260
3207,2023-10-22,3,3,3207000,673470,3880470
3208,2021-08-08,3,3,3208000,673680,3881680
3209,2022-06-20,1,3,3209000,673890,3882890
3210,2022-04-24,3,3,3210000,674100,3884100
3211,2022-05-20,2,3,3211000,674310,3885310
3212,2022-02-11,3,1,3212000,674520,3886520
3213,2021-05-17,1,2,3213000,674730,3887730
3214,2022-01-19,3,3,3214000,674940,3888940
3215,2024-10-11,1,1,3215000,675150,3890150
3216,2022-01-23,3,3,3216000,675360,3891360
3217,2021-10-17,3,1,3217000,675570,3892570
3218,2023-01-23,3,1,3218000,675780,3893780
3219,2020-10-21,1,3,3219000,675990,3894990
3220,2023-03-16,3,3,3220000,676200,3896200
3221,2023-09-06,2,2,3221000,676410,3897410
3222,2023-12-03,2,1,3222000,676620,3898620
3223,2020-07-19,1,3,3223000,676830,3899830
3224,2021-02-12,3,1,3224000,677040,3901040
3225,2020-03-24,2,2,3225000,677250,3902250
3226,2024-10-11,3,3,3226000,677460,3903460
3227,2021-10-24,2,3,3227000,677670,3904670
3228,2021-06-27,3,3,3228000,677880,3905880
3229,2023-01-09,1,1,3229000,678090,3907090
3230,2022-01-09,3,3,3230000,678300,3908300
3231,2022-02-10,2,1,3231000,678510,3909510
3232,2020-06-12,2,3,3232000,678720,3910720
3233,2023-01-08,2,1,3233000,678930,3911930
3234,2021-01-11,1,3,3234000,679140,3913140
3235,2024-02-11,3,1,3235000,679350,3914350
3236,2024-12-03,1,1,3236000,679560,3915560
3237,2020-12-12,3,1,3237000,679770,3916770
3238,2021-02-28,3,3,3238000,679980,3917980
3239,2020-06-20,1,2,3239000,680190,3919190
3240,2022-09-02,1,2,3240000,680400,3920400
3241,2021-07-25,1,1,3241000,680610,3921610
3242,2023-01-31,1,1,3242000,680820,3922820
3243,2022-06-01,2,1,3243000,681030,3924030
3244,2021-11-18,3,2,3244000,681240,3925240
3245,2020-05-11,2,3,3245000,681450,3926450
3246,2023-12-27,3,2,3246000,681660,3927660
3247,2024-08-05,1,1,3247000,681870,3928870
3248,2023-06-08,1,3,3248000,682080,3930080
3249,2024-01-27,1,2,3249000,682290,3931290
3250,2024-02-05,1,2,3250000,682500,3932500
3251,2023-11-28,1,3,3251000,682710,3933710
3252,2023-02-08,1,3,3252000,682920,3934920
3253,2024-10-27,1,2,3253000,683130,3936130
3254,2021-05-07,3,1,3254000,683340,3937340
3255,2024-03-20,1,1,3255000,683550,3938550
3256,2023-08-03,2,3,3256000,683760,3939760
3257,2022-01-03,2,2,3257000,683970,3940970
3258,2020-10-25,1,3,3258000,684180,3942180
3259,2024-05-19,3,3,3259000,684390,3943390
3260,2023-04-14,1,3,3260000,684600,3944600
3261,2024-04-07,3,1,3261000,684810,3945810
3262,2020-01-23,2,3,3262000,685020,3947020
3263,2023-09-30,1,1,3263000,685230,3948230
3264,2021-04-04,1,3,3264000,685440,3949440
3265,2021-01-25,2,2,3265000,685650,3950650
3266,2020-04-22,1,1,3266000,685860,3951860
3267,2020-08-02,1,3,3267000,686070,3953070
3268,2024-11-13,2,2,3268000,686280,3954280
3269,2023-01-25,3,3,3269000,686490,3955490
3270,2020-03-15,1,3,3270000,686700,3956700
3271,2023-06-23,2,3,3271000,686910,3957910
3272,2022-02-09,2,1,3272000,687120,3959120
3273,2021-09-28,1,2,3273000,687330,3960330
3274,2024-07-17,3,2,3274000,687540,3961540
3275,2023-01-06,2,2,3275000,687750,3962750
3276,2020-09-12,2,1,3276000,687960,3963960
3277,2024-01-26,1,3,3277000,688170,3965170
3278,2023-04-11,3,3,3278000,688380,3966380
3279,2023-06-27,3,2,3279000,688590,3967590
3280,2024-03-22,2,3,3280000,688800,3968800
3281,2022-01-24,3,3,3281000,689010,3970010
3282,2022-08-24,3,2,3282000,689220,3971220
3283,2020-06-04,3,3,3283000,689430,3972430
3284,2023-03-24,1,3,3284000,689640,3973640
3285,2020-07-11,3,1,3285000,689850,3974850
3286,2020-07-31,1,3,3286000,690060,3976060
3287,2021-09-30,3,2,3287000,690270,3977270
3288,2021-01-17,3,1,3288000,690480,3978480
3289,2020-03-01,2,2,3289000,690690,3979690
3290,2024-06-29,2,2,3290000,690900,3980900
3291,2021-07-09,2,3,3291000,691110,3982110
3292,2023-02-26,3,3,3292000,691320,3983320
3293,2020-08-08,3,1,3293000,691530,3984530
3294,2020-06-23,2,3,3294000,691740,3985740
3295,2021-01-22,1,1,3295000,691950,3986950
3296,2024-05-30,3,2,3296000,692160,3988160
3297,2022-01-04,2,3,3297000,692370,3989370
3298,2022-12-04,2,3,3298000,692580,3990580
3299,2022-08-05,2,2,3299000,692790,3991790
3300,2023-12-22,1,1,3300000,693000,3993000
3301,2022-05-27,2,1,3301000,693210,3994210
3302,2020-01-07,1,1,3302000,693420,3995420
3303,2020-03-27,1,3,3303000,693630,3996630
3304,2020-01-26,1,1,3304000,693840,3997840
3305,2024-02-02,2,3,3305000,694050,3999050
3306,2023-05-12,1,2,3306000,694260,4000260
3307,2022-07-01,1,1,3307000,694470,4001470
3308,2024-05-02,2,1,3308000,694680,4002680
3309,2021-12-25,1,3,3309000,694890,4003890
3310,2022-05-15,1,1,3310000,695100,4005100
3311,2022-02-12,1,2,3311000,695310,4006310
3312,2021-12-07,1,2,3312000,695520,4007520
3313,2024-11-06,1,1,3313000,695730,4008730
3314,2022-11-12,1,3,3314000,695940,4009940
3315,2024-07-05,2,1,3315000,696150,4011150
3316,2021-11-07,1,2,3316000,696360,4012360
3317,2024-05-22,3,2,3317000,696570,4013570
3318,2021-09-23,2,2,3318000,696780,4014780
3319,2024-09-16,1,2,3319000,696990,4015990
3320,2023-04-22,2,3,3320000,697200,4017200
3321,2020-03-26,3,1,3321000,697410,4018410
3322,2023-09-29,1,2,3322000,697620,4019620
3323,2020-10-26,2,1,3323000,697830,4020830
3324,2024-08-31,2,2,3324000,698040,4022040
3325,2021-09-26,3,1,3325000,698250,4023250
3326,2023-03-23,2,1,3326000,698460,4024460
3327,2021-12-12,3,1,3327000,698670,4025670
3328,2021-03-03,2,2,3328000,698880,4026880
3329,2024-04-29,2,2,3329000,699090,4028090
3330,2024-07-06,3,1,3330000,699300,4029300
3331,2021-04-28,3,1,3331000,699510,4030510
3332,2023-09-13,3,3,3332000,699720,4031720
3333,2020-02-26,1,3,3333000,699930,4032930
3334,2023-09-19,1,2,3334000,700140,4034140
3335,2022-05-19,1,2,3335000,700350,4035350
3336,2024-04-03,1,2,3336000,700560,4036560
3337,2020-02-22,1,2,3337000,700770,4037770
3338,2024-05-16,3,2,3338000,700980,4038980
3339,2022-01-26,1,1,3339000,701190,4040190
3340,2023-05-27,3,1,3340000,701400,4041400
3341,2020-09-12,1,3,3341000,701610,4042610
3342,2022-08-31,3,1,3342000,701820,4043820
3343,2022-07-24,3,2,3343000,702030,4045030
3344,2024-07-19,2,3,3344000,702240,4046240
3345,2023-10-30,1,3,3345000,702450,4047450
3346,2022-01-23,3,2,3346000,702660,4048660
3347,2023-11-28,1,3,3347000,702870,4049870
3348,2024-06-14,3,3,3348000,703080,4051080
3349,2023-06-09,1,1,3349000,703290,4052290
3350,2023-01-29,1,1,3350000,703500,4053500
3351,2023-09-18,2,3,3351000,703710,4054710
3352,2020-02-20,2,3,3352000,703920,4055920
3353,2020-11-23,2,1,3353000,704130,4057130
3354,2020-05-22,2,2,3354000,704340,4058340
3355,2020-02-16,2,1,3355000,704550,4059550
3356,2022-07-24,2,2,3356000,704760,4060760
3357,2023-08-30,3,3,3357000,704970,4061970
3358,2020-12-12,2,1,3358000,705180,4063180
3359,2022-08-14,1,2,3359000,705390,4064390
3360,2020-05-19,2,2,3360000,705600,4065600
3361,2022-07-07,2,1,3361000,705810,4066810
3362,2021-10-09,3,2,3362000,706020,4068020
3363,2021-07-16,1,1,3363000,706230,4069230
3364,2024-07-10,2,3,3364000,706440,4070440
3365,2023-01-29,3,1,3365000,706650,4071650
3366,2022-11-03,1,2,3366000,706860,4072860
3367,2022-03-31,2,2,3367000,707070,4074070
3368,2020-08-09,3,2,3368000,707280,4075280
3369,2021-11-08,1,2,3369000,707490,4076490
3370,2020-01-29,2,2,3370000,707700,4077700
3371,2021-02-04,2,1,3371000,707910,4078910
3372,2022-06-03,1,3,3372000,708120,4080120
3373,2022-04-12,1,1,3373000,708330,4081330
3374,2022-07-02,3,2,3374000,708540,4082540
3375,2023-01-05,2,3,3375000,708750,4083750
3376,2020-11-03,3,1,3376000,708960,4084960
3377,2023-10-14,2,3,3377000,709170,4086170
3378,2024-01-27,2,1,3378000,709380,4087380
3379,2021-02-01,3,3,3379000,709590,4088590
3380,2022-08-03,1,2,3380000,709800,4089800
3381,2023-05-23,3,2,3381000,710010,4091010
3382,2024-04-25,2,2,3382000,710220,4092220
3383,2024-10-25,3,1,3383000,710430,4093430
3384,2023-07-01,2,3,3384000,710640,4094640
3385,2024-05-26,1,2,3385000,710850,4095850
3386,2021-09-02,3,3,3386000,711060,4097060
3387,2024-11-03,3,3,3387000,711270,4098270
3388,2024-05-08,3,2,3388000,711480,4099480
3389,2024-01-11,3,1,3389000,711690,4100690
3390,2021-08-07,2,1,3390000,711900,4101900
3391,2020-04-15,1,3,3391000,712110,4103110
3392,2023-03-08,3,3,3392000,712320,4104320
3393,2023-01-04,2,3,3393000,712530,4105530
3394,2021-02-13,1,2,3394000,712740,4106740
3395,2022-10-07,2,1,3395000,712950,4107950
3396,2020-03-22,3,3,3396000,713160,4109160
3397,2024-06-10,1,2,3397000,713370,4110370
3398,2023-01-01,2,2,3398000,713580,4111580
3399,2023-03-27,2,2,3399000,713790,4112790
3400,2023-11-03,3,1,3400000,714000,4114000
3401,2020-11-10,2,2,3401000,714210,4115210
3402,2020-10-27,2,3,3402000,714420,4116420
3403,2024-09-04,2,2,3403000,714630,4117630
3404,2024-11-04,3,3,3404000,714840,4118840
3405,2023-03-04,3,1,3405000,715050,4120050
3406,2023-03-06,1,1,3406000,715260,4121260
3407,2024-01-05,2,3,3407000,715470,4122470
3408,2023-05-07,1,3,3408000,715680,4123680
3409,2024-07-26,2,2,3409000,715890,4124890
3410,2024-07-09,3,3,3410000,716100,4126100
3411,2022-03-05,3,2,3411000,716310,4127310
3412,2023-03-20,2,2,3412000,716520,4128520
3413,2020-03-25,2,3,3413000,716730,4129730
3414,2020-11-19,1,2,3414000,716940,4130940
3415,2024-05-08,2,1,3415000,717150,4132150
3416,2020-09-04,2,3,3416000,717360,4133360
3417,2020-04-14,2,2,3417000,717570,4134570
3418,2022-09-02,3,2,3418000,717780,4135780
3419,2021-01-20,3,3,3419000,717990,4136990
3420,2020-04-18,3,3,3420000,718200,4138200
3421,2021-04-07,3,1,3421000,718410,4139410
3422,2020-06-06,2,2,3422000,718620,4140620
3423,2022-05-29,1,1,3423000,718830,4141830
3424,2020-08-06,1,1,3424000,719040,4143040
3425,2020-09-26,3,1,3425000,719250,4144250
3426,2023-03-15,1,1,3426000,719460,4145460
3427,2022-06-27,1,2,3427000,719670,4146670
3428,2021-03-02,1,3,3428000,719880,4147880
3429,2023-09-04,2,2,3429000,720090,4149090
3430,2020-05-12,3,2,3430000,720300,4150300
3431,2021-01-03,2,3,3431000,720510,4151510
3432,2024-01-07,2,2,3432000,720720,4152720
3433,2024-09-08,1,1,3433000,720930,4153930
3434,2020-09-03,2,2,3434000,721140,4155140
3435,2022-07-15,3,1,3435000,721350,4156350
3436,2020-02-19,1,2,3436000,721560,4157560
3437,2021-10-01,3,2,3437000,721770,4158770
3438,2022-05-12,3,2,3438000,721980,4159980
3439,2020-11-04,2,3,3439000,722190,4161190
3440,2023-02-11,3,3,3440000,722400,4162400
3441,2021-06-08,1,3,3441000,722610,4163610
3442,2024-08-15,2,1,3442000,722820,4164820
3443,2022-12-28,3,3,3443000,723030,4166030
3444,2021-02-21,1,2,3444000,723240,4167240
3445,2020-03-14,3,1,3445000,723450,4168450
3446,2024-01-24,2,2,3446000,723660,4169660
3447,2023-03-09,1,3,3447000,723870,4170870
3448,2023-06-07,3,3,3448000,724080,4172080
3449,2020-07-03,3,2,3449000,724290,4173290
3450,2022-06-26,3,3,3450000,724500,4174500
3451,2023-01-29,2,1,3451000,724710,4175710
3452,2024-07-26,1,3,3452000,724920,4176920
3453,2024-09-25,2,2,3453000,725130,4178130
3454,2021-10-21,1,3,3454000,725340,4179340
3455,2020-10-07,1,2,3455000,725550,4180550
3456,2022-02-13,2,1,3456000,725760,4181760
3457,2023-02-07,1,2,3457000,725970,4182970
3458,2023-04-30,1,2,3458000,726180,4184180
3459,2022-01-17,3,3,3459000,726390,4185390
3460,2021-06-05,3,3,3460000,726600,4186600
3461,2024-08-23,2,2,3461000,726810,4187810
3462,2020-05-25,2,3,3462000,727020,4189020
3463,2024-02-11,3,2,3463000,727230,4190230
3464,2023-08-09,1,2,3464000,727440,4191440
3465,2024-03-23,3,3,3465000,727650,4192650
3466,2024-06-12,2,3,3466000,727860,4193860
3467,2020-09-16,2,3,3467000,728070,4195070
3468,2020-01-17,1,2,3468000,728280,4196280
3469,2022-05-28,1,1,3469000,728490,4197490
3470,2022-09-21,1,1,3470000,728700,4198700
3471,2024-07-22,3,2,3471000,728910,4199910
3472,2021-07-30,2,1,3472000,729120,4201120
3473,2021-12-06,1,1,3473000,729330,4202330
3474,2024-04-06,3,3,3474000,729540,4203540
3475,2024-10-17,1,2,3475000,729750,4204750
3476,2022-06-14,2,3,3476000,729960,4205960
3477,2021-01-10,2,3,3477000,730170,4207170
3478,2021-11-14,3,2,3478000,730380,4208380
3479,2024-07-19,2,1,3479000,730590,4209590
3480,2021-07-29,3,3,3480000,730800,4210800
3481,2024-09-12,2,3,3481000,731010,4212010
3482,2023-05-05,1,2,3482000,731220,4213220
3483,2020-03-23,1,3,3483000,731430,4214430
3484,2023-07-20,2,3,3484000,731640,4215640
3485,2024-01-06,1,2,3485000,731850,4216850
3486,2024-05-31,3,2,3486000,732060,4218060
3487,2023-03-13,2,1,3487000,732270,4219270
3488,2020-04-04,3,3,3488000,732480,4220480
3489,2021-11-16,3,2,3489000,732690,4221690
3490,2022-01-20,2,1,3490000,732900,4222900
3491,2024-08-04,1,3,3491000,733110,4224110
3492,2021-05-19,3,3,3492000,733320,4225320
3493,2020-03-06,2,1,3493000,733530,4226530
3494,2024-05-02,3,2,3494000,733740,4227740
3495,2024-10-23,1,2,3495000,733950,4228950
3496,2024-08-25,3,2,3496000,734160,4230160
3497,2020-08-19,2,1,3497000,734370,4231370
3498,2024-05-30,2,2,3498000,734580,4232580
3499,2024-03-24,1,1,3499000,734790,4233790
3500,2023-01-19,3,1,3500000,735000,4235000
3501,2021-12-15,2,1,3501000,735210,4236210
3502,2020-07-31,1,1,3502000,735420,4237420
3503,2021-01-20,3,3,3503000,735630,4238630
3504,2023-05-04,1,3,3504000,735840,4239840
3505,2024-03-13,1,2,3505000,736050,4241050
3506,2020-10-21,1,2,3506000,736260,4242260
3507,2021-05-08,1,2,3507000,736470,4243470
3508,2022-10-28,3,1,3508000,736680,4244680
3509,2023-12-12,2,2,3509000,736890,4245890
3510,2022-05-16,2,2,3510000,737100,4247100
3511,2023-05-13,3,2,3511000,737310,4248310
3512,2021-01-28,2,1,3512000,737520,4249520
3513,2023-11-03,2,2,3513000,737730,4250730
3514,2024-03-17,3,1,3514000,737940,4251940
3515,2024-06-18,1,2,3515000,738150,4253150
3516,2023-10-05,2,2,3516000,738360,4254360
3517,2024-08-21,1,3,3517000,738570,4255570
3518,2024-07-24,2,3,3518000,738780,4256780
3519,2022-12-07,3,1,3519000,738990,4257990
3520,2023-09-22,3,1,3520000,739200,4259200
3521,2020-02-06,1,1,3521000,739410,4260410
3522,2020-03-16,3,3,3522000,739620,4261620
3523,2021-08-11,1,2,3523000,739830,4262830
3524,2020-03-22,2,2,3524000,740040,4264040
3525,2021-02-07,3,3,3525000,740250,4265250
3526,2021-07-13,3,2,3526000,740460,4266460
3527,2024-07-25,1,2,3527000,740670,4267670
3528,2023-09-01,2,3,3528000,740880,4268880
3529,2021-05-10,1,2,3529000,741090,4270090
3530,2021-04-13,2,2,3530000,741300,4271300
3531,2020-03-21,1,1,3531000,741510,4272510
3532,2024-12-08,1,3,3532000,741720,4273720
3533,2022-08-21,3,3,3533000,741930,4274930
3534,2024-05-26,2,1,3534000,742140,4276140
3535,2022-02-06,3,2,3535000,742350,4277350
3536,2023-06-22,3,3,3536000,742560,4278560
3537,2023-07-02,3,3,3537000,742770,4279770
3538,2020-07-04,3,1,3538000,742980,4280980
3539,2021-09-17,1,1,3539000,743190,4282190
3540,2023-01-25,3,2,3540000,743400,4283400
3541,2024-05-08,2,1,3541000,743610,4284610
3542,2020-10-22,3,3,3542000,743820,4285820
3543,2022-02-14,2,1,3543000,744030,4287030
3544,2023-09-14,3,2,3544000,744240,4288240
3545,2020-05-03,3,3,3545000,744450,4289450
3546,2024-05-05,3,3,3546000,744660,4290660
3547,2023-01-10,2,2,3547000,744870,4291870
3548,2024-05-03,1,2,3548000,745080,4293080
3549,2022-10-05,1,3,3549000,745290,4294290
3550,2021-08-02,3,1,3550000,745500,4295500
3551,2020-12-02,1,3,3551000,745710,4296710
3552,2022-12-16,3,3,3552000,745920,4297920
3553,2023-11-01,1,2,3553000,746130,4299130
3554,2021-10-17,1,2,3554000,746340,4300340
3555,2021-12-08,2,3,3555000,746550,4301550
3556,2023-12-11,3,3,3556000,746760,4302760
3557,2023-08-09,3,1,3557000,746970,4303970
3558,2024-07-27,3,2,3558000,747180,4305180
3559,2024-05-13,2,3,3559000,747390,4306390
3560,2021-11-27,3,2,3560000,747600,4307600
3561,2022-09-20,3,1,3561000,747810,4308810
3562,2022-05-19,3,2,3562000,748020,4310020
3563,2020-05-28,3,1,3563000,748230,4311230
3564,2024-02-10,2,3,3564000,748440,4312440
3565,2024-09-23,3,2,3565000,748650,4313650
3566,2023-04-12,2,2,3566000,748860,4314860
3567,2020-05-23,2,1,3567000,749070,4316070
3568,2023-08-17,2,2,3568000,749280,4317280
3569,2022-11-14,3,1,3569000,749490,4318490
3570,2021-02-28,2,3,3570000,749700,4319700
3571,2023-01-15,3,2,3571000,749910,4320910
3572,2024-02-28,2,2,3572000,750120,4322120
3573,2023-04-03,3,3,3573000,750330,4323330
3574,2021-01-04,3,3,3574000,750540,4324540
3575,2020-06-04,3,3,3575000,750750,4325750
3576,2023-09-17,3,1,3576000,750960,4326960
3577,2024-10-01,2,3,3577000,751170,4328170
3578,2022-06-27,3,3,3578000,751380,4329380
3579,2024-10-15,3,1,3579000,751590,4330590
3580,2023-10-02,1,2,3580000,751800,4331800
3581,2020-05-22,3,3,3581000,752010,4333010
3582,2024-05-01,2,2,3582000,752220,4334220
3583,2021-01-09,3,3,3583000,752430,4335430
3584,2020-12-22,2,2,3584000,752640,4336640
3585,2024-11-05,2,3,3585000,752850,4337850
3586,2022-10-13,2,1,3586000,753060,4339060
3587,2022-12-25,2,3,3587000,753270,4340270
3588,2023-01-15,1,1,3588000,753480,4341480
3589,2024-02-04,3,1,3589000,753690,4342690
3590,2020-06-30,1,3,3590000,753900,4343900
3591,2023-07-28,2,3,3591000,754110,4345110
3592,2021-07-14,3,1,3592000,754320,4346320
3593,2021-05-31,1,1,3593000,754530,4347530
3594,2024-09-27,1,3,3594000,754740,4348740
3595,2022-03-18,1,1,3595000,754950,4349950
3596,2022-12-09,2,3,3596000,755160,4351160
3597,2020-05-17,3,2,3597000,755370,4352370
3598,2022-06-08,2,2,3598000,755580,4353580
3599,2022-10-05,2,3,3599000,755790,4354790
3600,2022-04-15,3,2,3600000,756000,4356000
3601,2020-06-09,3,3,3601000,756210,4357210
3602,2020-08-28,1,3,3602000,756420,4358420
3603,2024-08-30,3,2,3603000,756630,4359630
3604,2024-08-26,1,2,3604000,756840,4360840
3605,2021-10-15,2,2,3605000,757050,4362050
3606,2024-08-11,2,2,3606000,757260,4363260
3607,2024-01-14,2,1,3607000,757470,4364470
3608,2024-09-05,1,3,3608000,757680,4365680
3609,2022-12-03,1,3,3609000,757890,4366890
3610,2021-08-21,2,2,3610000,758100,4368100
3611,2024-05-04,3,2,3611000,758310,4369310
3612,2021-03-01,2,1,3612000,758520,4370520
3613,2023-08-01,2,2,3613000,758730,4371730
3614,2024-11-03,3,2,3614000,758940,4372940
3615,2020-06-19,1,1,3615000,759150,4374150
3616,2020-01-30,3,1,3616000,759360,4375360
3617,2020-04-10,1,3,3617000,759570,4376570
3618,2020-10-27,2,3,3618000,759780,4377780
3619,2020-11-23,3,3,3619000,759990,4378990
3620,2021-10-29,1,2,3620000,760200,4380200
3621,2023-09-16,2,1,3621000,760410,4381410
3622,2020-04-24,1,2,3622000,760620,4382620
3623,2023-11-06,1,1,3623000,760830,4383830
3624,2024-06-01,1,3,3624000,761040,4385040
3625,2021-07-02,1,3,3625000,761250,4386250
3626,2020-02-09,3,2,3626000,761460,4387460
3627,2020-08-08,1,2,3627000,761670,4388670
3628,2021-02-06,1,1,3628000,761880,4389880
3629,2024-04-22,1,3,3629000,762090,4391090
3630,2023-10-22,3,1,3630000,762300,4392300
3631,2022-03-17,2,3,3631000,762510,4393510
3632,2024-11-24,3,2,3632000,762720,4394720
3633,2022-07-11,2,3,3633000,762930,4395930
3634,2021-06-21,3,1,3634000,763140,4397140
3635,2021-06-24,3,2,3635000,763350,4398350
3636,2024-05-10,3,2,3636000,763560,4399560
3637,2024-09-16,1,1,3637000,763770,4400770
3638,2023-04-27,2,3,3638000,763980,4401980
3639,2022-05-06,3,2,3639000,764190,4403190
3640,2024-06-16,3,1,3640000,764400,4404400
3641,2022-11-02,3,2,3641000,764610,4405610
3642,2023-01-07,2,2,3642000,764820,4406820
3643,2022-04-09,3,3,3643000,765030,4408030
3644,2024-05-06,1,1,3644000,765240,4409240
3645,2024-03-03,2,2,3645000,765450,4410450
3646,2020-10-07,2,3,3646000,765660,4411660
3647,2023-10-17,1,1,3647000,765870,4412870
3648,2024-09-28,3,2,3648000,766080,4414080
3649,2024-08-03,3,3,3649000,766290,4415290
3650,2023-11-27,3,3,3650000,766500,4416500
3651,2024-10-19,3,3,3651000,766710,4417710
3652,2023-04-22,2,2,3652000,766920,4418920
3653,2022-06-03,2,3,3653000,767130,4420130
3654,2024-12-26,1,1,3654000,767340,4421340
3655,2021-04-20,2,3,3655000,767550,4422550
3656,2024-06-22,1,1,3656000,767760,4423760
3657,2024-03-02,3,3,3657000,767970,4424970
3658,2022-10-18,3,2,3658000,768180,4426180
3659,2023-07-18,2,1,3659000,768390,4427390
3660,2020-10-20,1,1,3660000,768600,4428600
3661,2023-01-17,1,2,3661000,768810,4429810
3662,2024-05-04,1,2,3662000,769020,4431020
3663,2020-07-20,2,3,3663000,769230,4432230
3664,2022-12-03,2,3,3664000,769440,4433440
3665,2022-01-21,3,2,3665000,769650,4434650
3666,2024-03-12,2,1,3666000,769860,4435860
3667,2021-01-28,3,1,3667000,770070,4437070
3668,2024-04-16,2,1,3668000,770280,4438280
3669,2021-06-24,3,3,3669000,770490,4439490
3670,2021-05-27,1,2,3670000,770700,4440700
3671,2022-09-08,1,1,3671000,770910,4441910
3672,2023-02-17,2,3,3672000,771120,4443120
3673,2024-08-30,2,3,3673000,771330,4444330
3674,2021-10-31,1,3,3674000,771540,4445540
3675,2020-09-05,3,2,3675000,771750,4446750
3676,2020-02-10,1,1,3676000,771960,4447960
3677,2021-02-05,3,2,3677000,772170,4449170
3678,2020-03-29,1,1,3678000,772380,4450380
3679,2020-10-30,3,3,3679000,772590,4451590
3680,2022-08-09,1,2,3680000,772800,4452800
3681,2021-11-18,3,2,3681000,773010,4454010
3682,2021-08-08,2,3,3682000,773220,4455220
3683,2021-05-17,2,1,3683000,773430,4456430
3684,2023-10-06,1,2,3684000,773640,4457640
3685,2020-03-01,1,3,3685000,773850,4458850
3686,2022-07-13,3,2,3686000,774060,4460060
3687,2022-03-17,3,3,3687000,774270,4461270
3688,2020-11-11,2,3,3688000,774480,4462480
3689,2023-05-30,1,3,3689000,774690,4463690
3690,2023-07-20,3,1,3690000,774900,4464900
3691,2021-12-04,2,1,3691000,775110,4466110
3692,2021-05-10,2,2,3692000,775320,4467320
3693,2021-10-13,1,2,3693000,775530,4468530
3694,2021-03-21,2,3,3694000,775740,4469740
3695,2020-10-25,1,3,3695000,775950,4470950
3696,2021-02-07,3,2,3696000,776160,4472160
3697,2022-02-06,1,1,3697000,776370,4473370
3698,2022-12-04,1,1,3698000,776580,4474580
3699,2022-11-16,1,1,3699000,776790,4475790
3700,2020-07-03,3,2,3700000,777000,4477000
3701,2024-07-02,3,1,3701000,777210,4478210
3702,2021-06-22,2,1,3702000,777420,4479420
3703,2021-08-30,3,3,3703000,777630,4480630
3704,2024-06-08,2,1,3704000,777840,4481840
3705,2023-12-25,3,2,3705000,778050,4483050
3706,2020-12-07,1,3,3706000,778260,4484260
3707,2022-01-25,2,2,3707000,778470,4485470
3708,2021-07-22,3,2,3708000,778680,4486680
3709,2022-05-24,1,1,3709000,778890,4487890
3710,2021-03-20,3,2,3710000,779100,4489100
3711,2024-04-01,3,2,3711000,779310,4490310
3712,2021-11-17,1,3,3712000,779520,4491520
3713,2022-08-03,1,3,3713000,779730,4492730
3714,2024-11-13,2,1,3714000,779940,4493940
3715,2024-03-10,1,3,3715000,780150,4495150
3716,2022-01-17,1,2,3716000,780360,4496360
3717,2020-03-26,3,2,3717000,780570,4497570
3718,2020-12-25,3,2,3718000,780780,4498780
3719,2021-04-01,1,1,3719000,780990,4499990
3720,2021-07-09,2,1,3720000,781200,4501200
3721,2020-07-21,1,3,3721000,781410,4502410
3722,2021-10-14,3,3,3722000,781620,4503620
3723,2020-08-11,1,2,3723000,781830,4504830
3724,2020-12-26,3,3,3724000,782040,4506040
3725,2020-06-04,2,3,3725000,782250,4507250
3726,2020-08-01,1,1,3726000,782460,4508460
3727,2023-08-15,3,2,3727000,782670,4509670
3728,2023-10-11,2,1,3728000,782880,4510880
3729,2024-07-23,1,1,3729000,783090,4512090
3730,2022-05-11,2,3,3730000,783300,4513300
3731,2024-12-20,1,1,3731000,783510,4514510
3732,2020-09-27,2,1,3732000,783720,4515720
3733,2020-11-17,3,2,3733000,783930,4516930
3734,2021-03-26,1,3,3734000,784140,4518140
3735,2022-09-14,3,2,3735000,784350,4519350
3736,2021-08-11,2,1,3736000,784560,4520560
3737,2021-09-11,2,2,3737000,784770,4521770
3738,2022-10-10,1,3,3738000,784980,4522980
3739,2023-03-24,3,3,3739000,785190,4524190
3740,2024-07-08,1,2,3740000,785400,4525400
3741,2022-04-11,2,2,3741000,785610,4526610
3742,2023-07-08,1,1,3742000,785820,4527820
3743,2021-07-26,1,1,3743000,786030,4529030
3744,2024-07-14,3,3,3744000,786240,4530240
3745,2024-04-17,3,3,3745000,786450,4531450
3746,2024-01-14,3,2,3746000,786660,4532660
3747,2023-08-12,2,1,3747000,786870,4533870
3748,2023-11-26,2,2,3748000,787080,4535080
3749,2020-12-09,1,2,3749000,787290,4536290
3750,2022-04-22,1,3,3750000,787500,4537500
3751,2021-03-22,2,3,3751000,787710,4538710
3752,2021-08-09,3,2,3752000,787920,4539920
3753,2023-08-23,1,3,3753000,788130,4541130
3754,2022-11-03,1,1,3754000,788340,4542340
3755,2023-08-14,3,1,3755000,788550,4543550
3756,2022-08-27,1,1,3756000,788760,4544760
3757,2023-06-11,1,3,3757000,788970,4545970
3758,2021-07-04,2,3,3758000,789180,4547180
3759,2023-08-31,3,1,3759000,789390,4548390
3760,2023-07-10,1,2,3760000,789600,4549600
3761,2022-10-29,3,3,3761000,789810,4550810
3762,2024-03-09,2,2,3762000,790020,4552020
3763,2022-05-26,1,1,3763000,790230,4553230
3764,2021-10-07,1,1,3764000,790440,4554440
3765,2022-10-26,2,3,3765000,790650,4555650
3766,2022-02-04,1,2,3766000,790860,4556860
3767,2021-06-23,3,2,3767000,791070,4558070
3768,2021-07-03,2,1,3768000,791280,4559280
3769,2023-08-29,2,1,3769000,791490,4560490
3770,2020-02-27,3,3,3770000,791700,4561700
3771,2020-07-25,2,1,3771000,791910,4562910
3772,2021-02-02,2,1,3772000,792120,4564120
3773,2021-12-05,2,1,3773000,792330,4565330
3774,2020-07-24,3,2,3774000,792540,4566540
3775,2022-05-09,2,3,3775000,792750,4567750
3776,2024-04-23,2,1,3776000,792960,4568960
3777,2022-03-13,2,2,3777000,793170,4570170
3778,2021-06-22,2,2,3778000,793380,4571380
3779,2023-03-24,3,2,3779000,793590,4572590
3780,2023-08-19,2,3,3780000,793800,4573800
3781,2023-09-13,2,3,3781000,794010,4575010
3782,2024-06-21,3,2,3782000,794220,4576220
3783,2023-05-10,3,1,3783000,794430,4577430
3784,2020-06-04,2,2,3784000,794640,4578640
3785,2024-05-01,1,3,3785000,794850,4579850
3786,2021-08-23,2,1,3786000,795060,4581060
3787,2021-04-21,3,2,3787000,795270,4582270
3788,2020-03-02,2,2,3788000,795480,4583480
3789,2021-12-14,3,2,3789000,795690,4584690
3790,2020-03-29,2,2,3790000,795900,4585900
3791,2023-12-07,2,3,3791000,796110,4587110
3792,2024-06-15,3,2,3792000,796320,4588320
3793,2021-12-02,2,2,3793000,796530,4589530
3794,2022-03-11,1,2,3794000,796740,4590740
3795,2021-06-21,2,1,3795000,796950,4591950
3796,2022-02-08,1,2,3796000,797160,4593160
3797,2021-11-16,1,2,3797000,797370,4594370
3798,2020-08-17,2,2,3798000,797580,4595580
3799,2024-09-12,3,1,3799000,797790,4596790
3800,2022-01-10,3,2,3800000,798000,4598000
3801,2020-01-05,3,1,3801000,798210,4599210
3802,2024-05-22,1,2,3802000,798420,4600420
3803,2020-10-21,3,3,3803000,798630,4601630
3804,2024-07-26,2,2,3804000,798840,4602840
3805,2020-04-15,1,1,3805000,799050,4604050
3806,2022-11-26,3,2,3806000,799260,4605260
3807,2022-10-06,1,3,3807000,799470,4606470
3808,2020-12-29,1,2,3808000,799680,4607680
3809,2024-09-27,3,3,3809000,799890,4608890
3810,2023-11-09,1,2,3810000,800100,4610100
3811,2020-10-01,1,2,3811000,800310,4611310
3812,2020-09-05,1,3,3812000,800520,4612520
3813,2023-01-18,3,2,3813000,800730,4613730
3814,2020-05-19,1,1,3814000,800940,4614940
3815,2022-05-12,1,1,3815000,801150,4616150
3816,2024-12-16,3,2,3816000,801360,4617360
3817,2020-11-04,2,2,3817000,801570,4618570
3818,2020-12-03,3,1,3818000,801780,4619780
3819,2023-05-07,1,1,3819000,801990,4620990
3820,2024-07-29,3,1,3820000,802200,4622200
3821,2023-06-13,3,1,3821000,802410,4623410
3822,2021-07-10,2,2,3822000,802620,4624620
3823,2020-07-30,1,2,3823000,802830,4625830
3824,2023-08-28,3,3,3824000,803040,4627040
3825,2021-02-25,2,1,3825000,803250,4628250
3826,2024-10-30,3,3,3826000,803460,4629460
3827,2023-06-21,3,1,3827000,803670,4630670
3828,2024-08-17,1,2,3828000,803880,4631880
3829,2024-01-06,1,1,3829000,804090,4633090
3830,2022-01-01,3,2,3830000,804300,4634300
3831,2020-10-09,3,3,3831000,804510,4635510
3832,2022-03-09,3,2,3832000,804720,4636720
3833,2023-04-15,3,3,3833000,804930,4637930
3834,2021-08-15,3,2,3834000,805140,4639140
3835,2021-03-01,3,1,3835000,805350,4640350
3836,2023-08-31,2,2,3836000,805560,4641560
3837,2020-01-09,3,2,3837000,805770,4642770
3838,2023-11-08,2,1,3838000,805980,4643980
3839,2023-12-19,1,1,3839000,806190,4645190
3840,2022-09-10,3,1,3840000,806400,4646400
3841,2021-06-08,1,1,3841000,806610,4647610
3842,2023-11-09,2,1,3842000,806820,4648820
3843,2024-06-24,3,2,3843000,807030,4650030
3844,2022-03-21,2,1,3844000,807240,4651240
3845,2022-03-29,1,2,3845000,807450,4652450
3846,2022-01-06,2,2,3846000,807660,4653660
3847,2022-05-26,3,2,3847000,807870,4654870
3848,2021-01-09,2,1,3848000,808080,4656080
3849,2021-10-16,1,3,3849000,808290,4657290
3850,2022-05-04,3,3,3850000,808500,4658500
3851,2024-11-17,1,3,3851000,808710,4659710
3852,2024-09-22,3,2,3852000,808920,4660920
3853,2024-01-18,2,2,3853000,809130,4662130
3854,2024-02-15,2,2,3854000,809340,4663340
3855,2023-02-14,1,1,3855000,809550,4664550
3856,2023-12-02,1,3,3856000,809760,4665760
3857,2023-09-28,1,1,3857000,809970,4666970
3858,2024-08-31,1,2,3858000,810180,4668180
3859,2021-01-03,3,2,3859000,810390,4669390
3860,2020-09-17,3,3,3860000,810600,4670600
3861,2020-09-22,2,1,3861000,810810,4671810
3862,2021-06-07,1,3,3862000,811020,4673020
3863,2023-09-24,2,3,3863000,811230,4674230
3864,2023-07-07,3,1,3864000,811440,4675440
3865,2023-09-29,1,2,3865000,811650,4676650
3866,2023-12-27,2,3,3866000,811860,4677860
3867,2023-01-13,1,3,3867000,812070,4679070
3868,2023-05-13,2,3,3868000,812280,4680280
3869,2023-01-30,1,1,3869000,812490,4681490
3870,2021-08-27,1,3,3870000,812700,4682700
3871,2023-04-23,3,2,3871000,812910,4683910
3872,2024-09-14,1,3,3872000,813120,4685120
3873,2020-09-02,3,1,3873000,813330,4686330
3874,2022-04-20,1,2,3874000,813540,4687540
3875,2021-03-21,2,1,3875000,813750,4688750
3876,2023-07-09,1,1,3876000,813960,4689960
3877,2021-01-26,1,1,3877000,814170,4691170
3878,2023-06-30,2,3,3878000,814380,4692380
3879,2023-05-25,3,3,3879000,814590,4693590
3880,2020-05-10,2,2,3880000,814800,4694800
3881,2024-09-20,2,3,3881000,815010,4696010
3882,2024-06-24,3,2,3882000,815220,4697220
3883,2023-01-19,1,2,3883000,815430,4698430
3884,2020-01-13,3,3,3884000,815640,4699640
3885,2024-07-19,2,2,3885000,815850,4700850
3886,2022-05-16,3,3,3886000,816060,4702060
3887,2024-09-27,1,2,3887000,816270,4703270
3888,2023-10-09,3,2,3888000,816480,4704480
3889,2023-08-30,2,3,3889000,816690,4705690
3890,2020-06-11,3,3,3890000,816900,4706900
3891,2020-05-17,3,2,3891000,817110,4708110
3892,2022-09-01,2,1,3892000,817320,4709320
3893,2024-04-07,1,3,3893000,817530,4710530
3894,2021-01-05,2,3,3894000,817740,4711740
3895,2021-07-01,2,1,3895000,817950,4712950
3896,2023-11-04,1,1,3896000,818160,4714160
3897,2024-09-18,1,2,3897000,818370,4715370
3898,2023-12-15,1,3,3898000,818580,4716580
3899,2020-08-25,2,3,3899000,818790,4717790
3900,2021-01-26,3,2,3900000,819000,4719000
3901,2020-02-14,1,2,3901000,819210,4720210
3902,2023-12-05,3,1,3902000,819420,4721420
3903,2024-05-12,2,2,3903000,819630,4722630
3904,2023-11-10,3,2,3904000,819840,4723840
3905,2021-02-22,2,2,3905000,820050,4725050
3906,2020-12-27,3,2,3906000,820260,4726260
3907,2020-07-11,3,1,3907000,820470,4727470
3908,2024-05-26,2,2,3908000,820680,4728680
3909,2023-09-03,3,2,3909000,820890,4729890
3910,2023-03-21,1,1,3910000,821100,4731100
3911,2020-09-05,3,3,3911000,821310,4732310
3912,2022-06-27,2,3,3912000,821520,4733520
3913,2022-07-15,2,1,3913000,821730,4734730
3914,2023-07-04,3,1,3914000,821940,4735940
3915,2023-12-25,3,3,3915000,822150,4737150
3916,2022-10-12,3,3,3916000,822360,4738360
3917,2021-03-30,3,1,3917000,822570,4739570
3918,2024-01-15,1,1,3918000,822780,4740780
3919,2024-05-06,3,2,3919000,822990,4741990
3920,2023-07-13,2,2,3920000,823200,4743200
3921,2020-08-06,3,2,3921000,823410,4744410
3922,2022-04-18,2,3,3922000,823620,4745620
3923,2021-11-09,3,1,3923000,823830,4746830
3924,2022-03-10,2,3,3924000,824040,4748040
3925,2023-09-29,1,3,3925000,824250,4749250
3926,2021-07-24,1,2,3926000,824460,4750460
3927,2020-10-27,3,2,3927000,824670,4751670
3928,2021-06-04,3,1,3928000,824880,4752880
3929,2024-11-03,2,3,3929000,825090,4754090
3930,2020-07-10,1,3,3930000,825300,4755300
3931,2021-04-26,1,1,3931000,825510,4756510
3932,2023-06-09,2,2,3932000,825720,4757720
3933,2021-01-18,1,3,3933000,825930,4758930
3934,2022-02-13,3,3,3934000,826140,4760140
3935,2024-03-04,1,2,3935000,826350,4761350
3936,2020-01-25,1,2,3936000,826560,4762560
3937,2023-12-28,3,2,3937000,826770,4763770
3938,2021-08-31,1,2,3938000,826980,4764980
3939,2023-11-09,1,1,3939000,827190,4766190
3940,2023-06-18,3,2,3940000,827400,4767400
3941,2021-08-16,3,3,3941000,827610,4768610
3942,2022-04-05,3,1,3942000,827820,4769820
3943,2021-08-08,1,3,3943000,828030,4771030
3944,2021-12-23,2,1,3944000,828240,4772240
3945,2023-12-22,1,1,3945000,828450,4773450
3946,2024-04-06,1,3,3946000,828660,4774660
3947,2024-01-29,3,2,3947000,828870,4775870
3948,2023-05-28,1,1,3948000,829080,4777080
3949,2023-12-10,2,3,3949000,829290,4778290
3950,2022-10-18,2,1,3950000,829500,4779500
3951,2021-04-09,3,3,3951000,829710,4780710
3952,2023-11-14,1,2,3952000,829920,4781920
3953,2021-09-03,1,1,3953000,830130,4783130
3954,2024-11-24,2,1,3954000,830340,4784340
3955,2020-06-16,3,3,3955000,830550,4785550
3956,2022-11-18,1,3,3956000,830760,4786760
3957,2020-10-29,2,1,3957000,830970,4787970
3958,2024-05-15,1,2,3958000,831180,4789180
3959,2023-02-03,2,1,3959000,831390,4790390
3960,2023-05-05,2,3,3960000,831600,4791600
3961,2021-06-02,1,2,3961000,831810,4792810
3962,2020-06-16,2,2,3962000,832020,4794020
3963,2020-09-20,1,1,3963000,832230,4795230
3964,2021-06-03,1,2,3964000,832440,4796440
3965,2020-06-03,3,3,3965000,832650,4797650
3966,2023-09-03,3,1,3966000,832860,4798860
3967,2023-08-07,2,3,3967000,833070,4800070
3968,2021-04-25,2,3,3968000,833280,4801280
3969,2023-02-15,2,3,3969000,833490,4802490
3970,2021-08-29,2,1,3970000,833700,4803700
3971,2021-04-19,2,2,3971000,833910,4804910
3972,2022-09-17,2,2,3972000,834120,4806120
3973,2022-09-12,3,1,3973000,834330,4807330
3974,2022-07-16,2,1,3974000,834540,4808540
3975,2024-10-27,3,1,3975000,834750,4809750
3976,2022-04-07,2,3,3976000,834960,4810960
3977,2020-06-30,2,2,3977000,835170,4812170
3978,2020-11-18,2,2,3978000,835380,4813380
3979,2022-12-08,2,1,3979000,835590,4814590
3980,2022-06-15,1,1,3980000,835800,4815800
3981,2023-08-29,1,3,3981000,836010,4817010
3982,2022-08-31,1,3,3982000,836220,4818220
3983,2021-06-12,1,1,3983000,836430,4819430
3984,2024-07-26,3,1,3984000,836640,4820640
3985,2020-06-24,2,1,3985000,836850,4821850
3986,2021-12-15,1,2,3986000,837060,4823060
3987,2022-09-07,3,2,3987000,837270,4824270
3988,2021-02-25,2,3,3988000,837480,4825480
3989,2021-01-21,3,3,3989000,837690,4826690
3990,2023-10-21,3,3,3990000,837900,4827900
3991,2021-10-19,2,2,3991000,838110,4829110
3992,2023-05-14,1,3,3992000,838320,4830320
3993,2020-01-27,3,1,3993000,838530,4831530
3994,2020-01-16,2,3,3994000,838740,4832740
3995,2024-08-16,2,3,3995000,838950,4833950
3996,2020-12-06,3,3,3996000,839160,4835160
3997,2024-06-02,1,3,3997000,839370,4836370
3998,2024-12-06,2,1,3998000,839580,4837580
3999,2023-04-23,2,2,3999000,839790,4838790
4000,2021-06-18,1,2,4000000,840000,4840000
4001,2024-03-19,1,3,4001000,840210,4841210
4002,2020-01-25,1,2,4002000,840420,4842420
4003,2021-04-11,3,3,4003000,840630,4843630
4004,2020-10-18,2,3,4004000,840840,4844840
4005,2020-12-29,3,3,4005000,841050,4846050
4006,2023-12-18,3,2,4006000,841260,4847260
4007,2024-08-01,2,1,4007000,841470,4848470
4008,2023-03-10,1,3,4008000,841680,4849680
4009,2020-01-26,3,1,4009000,841890,4850890
4010,2023-05-16,3,2,4010000,842100,4852100
4011,2020-05-17,3,2,4011000,842310,4853310
4012,2023-02-18,3,2,4012000,842520,4854520
4013,2020-11-05,1,3,4013000,842730,4855730
4014,2020-07-19,3,1,4014000,842940,4856940
4015,2021-02-03,2,3,4015000,843150,4858150
4016,2021-06-14,2,3,4016000,843360,4859360
4017,2021-08-13,3,1,4017000,843570,4860570
4018,2022-02-27,1,1,4018000,843780,4861780
4019,2022-08-11,1,3,4019000,843990,4862990
4020,2021-09-03,2,2,4020000,844200,4864200
4021,2023-05-16,2,2,4021000,844410,4865410
4022,2021-01-01,1,3,4022000,844620,4866620
4023,2020-01-10,2,3,4023000,844830,4867830
4024,2020-04-16,1,3,4024000,845040,4869040
4025,2021-11-18,2,1,4025000,845250,4870250
4026,2020-02-02,1,2,4026000,845460,4871460
4027,2021-04-23,2,1,4027000,845670,4872670
4028,2022-04-20,3,1,4028000,845880,4873880
4029,2022-10-06,2,3,4029000,846090,4875090
4030,2024-12-04,1,3,4030000,846300,4876300
4031,2024-11-11,3,2,4031000,846510,4877510
4032,2024-07-09,1,2,4032000,846720,4878720
4033,2023-04-27,1,1,4033000,846930,4879930
4034,2023-05-28,1,1,4034000,847140,4881140
4035,2024-10-07,3,2,4035000,847350,4882350
4036,2021-03-12,2,3,4036000,847560,4883560
4037,2024-06-04,2,1,4037000,847770,4884770
4038,2022-04-27,2,3,4038000,847980,4885980
4039,2024-02-15,3,1,4039000,848190,4887190
4040,2023-07-04,1,1,4040000,848400,4888400
4041,2020-11-28,1,1,4041000,848610,4889610
4042,2022-03-03,3,2,4042000,848820,4890820
4043,2020-02-25,1,2,4043000,849030,4892030
4044,2022-04-11,1,3,4044000,849240,4893240
4045,2021-02-18,2,3,4045000,849450,4894450
4046,2023-10-04,3,1,4046000,849660,4895660
4047,2023-07-22,1,1,4047000,849870,4896870
4048,2021-06-29,1,1,4048000,850080,4898080
4049,2024-06-20,1,2,4049000,850290,4899290
4050,2024-01-15,2,1,4050000,850500,4900500
4051,2024-01-23,2,2,4051000,850710,4901710
4052,2022-10-04,1,2,4052000,850920,4902920
4053,2020-08-08,2,2,4053000,851130,4904130
4054,2022-11-20,3,2,4054000,851340,4905340
4055,2023-02-26,3,1,4055000,851550,4906550
4056,2022-01-21,3,3,4056000,851760,4907760
4057,2021-06-05,1,2,4057000,851970,4908970
4058,2020-10-17,1,3,4058000,852180,4910180
4059,2022-01-13,2,3,4059000,852390,4911390
4060,2021-10-28,2,3,4060000,852600,4912600
4061,2020-07-13,2,1,4061000,852810,4913810
4062,2021-12-11,2,2,4062000,853020,4915020
4063,2020-06-10,2,2,4063000,853230,4916230
4064,2022-05-15,1,1,4064000,853440,4917440
4065,2022-07-23,3,2,4065000,853650,4918650
4066,2023-06-03,3,2,4066000,853860,4919860
4067,2020-02-14,1,1,4067000,854070,4921070
4068,2024-01-31,3,1,4068000,854280,4922280
4069,2021-04-05,1,3,4069000,854490,4923490
4070,2024-10-02,1,3,4070000,854700,4924700
4071,2022-01-14,3,1,4071000,854910,4925910
4072,2023-12-10,3,3,4072000,855120,4927120
4073,2021-06-14,1,1,4073000,855330,4928330
4074,2021-09-28,2,1,4074000,855540,4929540
4075,2021-06-03,2,3,4075000,855750,4930750
4076,2020-08-31,2,3,4076000,855960,4931960
4077,2023-04-28,1,1,4077000,856170,4933170
4078,2024-09-10,3,2,4078000,856380,4934380
4079,2022-10-09,3,2,4079000,856590,4935590
4080,2021-01-22,3,1,4080000,856800,4936800
4081,2021-01-03,2,1,4081000,857010,4938010
4082,2020-09-16,1,1,4082000,857220,4939220
4083,2024-11-04,2,3,4083000,857430,4940430
4084,2023-11-24,3,3,4084000,857640,4941640
4085,2021-07-02,2,2,4085000,857850,4942850
4086,2020-11-09,2,3,4086000,858060,4944060
4087,2020-02-04,3,3,4087000,858270,4945270
4088,2024-08-07,3,2,4088000,858480,4946480
4089,2024-02-10,1,3,4089000,858690,4947690
4090,2024-04-15,3,2,4090000,858900,4948900
4091,2020-02-01,2,2,4091000,859110,4950110
4092,2020-11-18,2,1,4092000,859320,4951320
4093,2024-01-08,3,2,4093000,859530,4952530
4094,2021-05-01,1,1,4094000,859740,4953740
4095,2021-11-23,2,2,4095000,859950,4954950
4096,2021-10-30,3,1,4096000,860160,4956160
4097,2020-05-24,1,3,4097000,860370,4957370
4098,2020-10-06,2,2,4098000,860580,4958580
4099,2023-05-10,2,1,4099000,860790,4959790
4100,2020-11-24,2,1,4100000,861000,4961000
4101,2023-04-02,3,1,4101000,861210,4962210
4102,2022-10-06,1,2,4102000,861420,4963420
4103,2024-03-07,3,1,4103000,861630,4964630
4104,2024-05-15,1,2,4104000,861840,4965840
4105,2023-11-09,3,2,4105000,862050,4967050
4106,2021-03-04,3,1,4106000,862260,4968260
4107,2022-10-14,1,3,4107000,862470,4969470
4108,2022-10-27,2,2,4108000,862680,4970680
4109,2024-04-13,1,1,4109000,862890,4971890
4110,2024-09-17,1,1,4110000,863100,4973100
4111,2021-10-17,1,2,4111000,863310,4974310
4112,2023-08-01,3,1,4112000,863520,4975520
4113,2024-06-21,3,3,4113000,863730,4976730
4114,2021-06-23,1,2,4114000,863940,4977940
4115,2020-05-09,2,1,4115000,864150,4979150
4116,2022-04-22,1,1,4116000,864360,4980360
4117,2022-05-18,2,2,4117000,864570,4981570
4118,2022-03-20,2,3,4118000,864780,4982780
4119,2024-09-13,2,3,4119000,864990,4983990
4120,2022-09-03,2,3,4120000,865200,4985200
4121,2023-03-29,2,2,4121000,865410,4986410
4122,2023-07-28,1,3,4122000,865620,4987620
4123,2024-01-12,3,2,4123000,865830,4988830
4124,2022-08-25,1,1,4124000,866040,4990040
4125,2023-01-31,3,3,4125000,866250,4991250
4126,2020-09-08,2,1,4126000,866460,4992460
4127,2023-02-01,1,3,4127000,866670,4993670
4128,2020-12-02,3,2,4128000,866880,4994880
4129,2020-03-15,1,3,4129000,867090,4996090
4130,2022-01-23,1,3,4130000,867300,4997300
4131,2023-04-03,2,2,4131000,867510,4998510
4132,2020-01-10,2,2,4132000,867720,4999720
4133,2023-09-13,2,1,4133000,867930,5000930
4134,2024-12-01,2,3,4134000,868140,5002140
4135,2022-02-22,1,2,4135000,868350,5003350
4136,2023-09-09,2,3,4136000,868560,5004560
4137,2021-09-16,3,2,4137000,868770,5005770
4138,2023-11-09,2,2,4138000,868980,5006980
4139,2024-06-13,3,2,4139000,869190,5008190
4140,2020-07-29,1,2,4140000,869400,5009400
4141,2024-06-03,2,3,4141000,869610,5010610
4142,2022-09-08,3,3,4142000,869820,5011820
4143,2021-01-25,1,1,4143000,870030,5013030
4144,2021-09-04,1,3,4144000,870240,5014240
4145,2021-10-15,2,3,4145000,870450,5015450
4146,2020-09-26,3,2,4146000,870660,5016660
4147,2023-01-17,1,3,4147000,870870,5017870
4148,2020-12-15,2,1,4148000,871080,5019080
4149,2022-10-18,2,1,4149000,871290,5020290
4150,2024-07-11,2,1,4150000,871500,5021500
4151,2024-08-30,1,1,4151000,871710,5022710
4152,2022-02-07,2,3,4152000,871920,5023920
4153,2023-03-29,3,1,4153000,872130,5025130
4154,2020-12-13,3,2,4154000,872340,5026340
4155,2022-05-22,3,1,4155000,872550,5027550
4156,2020-03-20,3,3,4156000,872760,5028760
4157,2024-11-03,1,1,4157000,872970,5029970
4158,2020-04-28,1,2,4158000,873180,5031180
4159,2023-10-22,1,1,4159000,873390,5032390
4160,2022-12-09,1,2,4160000,873600,5033600
4161,2020-06-10,2,2,4161000,873810,5034810
4162,2022-05-03,3,3,4162000,874020,5036020
4163,2020-07-04,2,1,4163000,874230,5037230
4164,2021-06-12,1,1,4164000,874440,5038440
4165,2021-02-02,3,1,4165000,874650,5039650
4166,2022-04-27,1,3,4166000,874860,5040860
4167,2021-01-07,1,2,4167000,875070,5042070
4168,2024-05-16,3,2,4168000,875280,5043280
4169,2022-01-13,1,1,4169000,875490,5044490
4170,2021-04-08,2,1,4170000,875700,5045700
4171,2024-08-28,2,3,4171000,875910,5046910
4172,2022-06-26,1,2,4172000,876120,5048120
4173,2022-06-13,2,3,4173000,876330,5049330
4174,2022-05-01,1,1,4174000,876540,5050540
4175,2024-12-28,1,2,4175000,876750,5051750
4176,2021-10-15,1,1,4176000,876960,5052960
4177,2021-10-03,2,3,4177000,877170,5054170
4178,2020-01-27,1,2,4178000,877380,5055380
4179,2024-11-08,3,2,4179000,877590,5056590
4180,2020-10-21,2,3,4180000,877800,5057800
4181,2023-02-07,2,1,4181000,878010,5059010
4182,2023-09-24,3,3,4182000,878220,5060220
4183,2021-12-05,3,3,4183000,878430,5061430
4184,2022-06-12,2,3,4184000,878640,5062640
4185,2021-01-05,3,1,4185000,878850,5063850
4186,2022-01-08,3,3,4186000,879060,5065060
4187,2023-05-10,1,1,4187000,879270,5066270
4188,2022-02-15,3,1,4188000,879480,5067480
4189,2024-11-23,2,2,4189000,879690,5068690
4190,2023-11-02,3,1,4190000,879900,5069900
4191,2023-04-01,2,1,4191000,880110,5071110
4192,2021-12-22,2,3,4192000,880320,5072320
4193,2020-07-12,2,1,4193000,880530,5073530
4194,2022-10-24,3,3,4194000,880740,5074740
4195,2021-05-26,3,3,4195000,880950,5075950
4196,2022-02-05,3,3,4196000,881160,5077160
4197,2024-07-16,2,3,4197000,881370,5078370
4198,2023-12-28,3,2,4198000,881580,5079580
4199,2024-02-17,1,1,4199000,881790,5080790
4200,2021-10-21,3,1,4200000,882000,5082000
4201,2020-12-07,2,3,4201000,882210,5083210
4202,2024-04-01,1,3,4202000,882420,5084420
4203,2021-12-26,3,1,4203000,882630,5085630
4204,2021-09-03,2,2,4204000,882840,5086840
4205,2023-02-09,2,1,4205000,883050,5088050
4206,2022-05-01,2,1,4206000,883260,5089260
4207,2021-11-17,2,2,4207000,883470,5090470
4208,2020-09-04,2,2,4208000,883680,5091680
4209,2023-10-21,1,2,4209000,883890,5092890
4210,2021-11-15,2,2,4210000,884100,5094100
4211,2020-03-29,3,2,4211000,884310,5095310
4212,2023-06-16,1,2,4212000,884520,5096520
4213,2024-08-22,3,1,4213000,884730,5097730
4214,2021-10-07,2,1,4214000,884940,5098940
4215,2022-03-05,3,3,4215000,885150,5100150
4216,2020-12-05,3,2,4216000,885360,5101360
4217,2022-05-15,1,2,4217000,885570,5102570
4218,2020-11-11,2,1,4218000,885780,5103780
4219,2023-03-29,1,2,4219000,885990,5104990
4220,2021-09-14,1,1,4220000,886200,5106200
4221,2022-02-25,3,1,4221000,886410,5107410
4222,2024-08-31,1,1,4222000,886620,5108620
4223,2021-06-28,2,1,4223000,886830,5109830
4224,2020-12-22,1,1,4224000,887040,5111040
4225,2022-02-19,3,3,4225000,887250,5112250
4226,2023-11-27,1,2,4226000,887460,5113460
4227,2020-06-29,1,3,4227000,887670,5114670
4228,2020-01-09,3,2,4228000,887880,5115880
4229,2021-08-16,2,1,4229000,888090,5117090
4230,2021-12-16,3,3,4230000,888300,5118300
4231,2024-11-17,1,2,4231000,888510,5119510
4232,2020-09-08,1,2,4232000,888720,5120720
4233,2022-07-18,2,2,4233000,888930,5121930
4234,2024-12-19,3,2,4234000,889140,5123140
4235,2022-07-07,1,2,4235000,889350,5124350
4236,2022-03-02,2,2,4236000,889560,5125560
4237,2024-12-06,2,1,4237000,889770,5126770
4238,2023-06-30,1,3,4238000,889980,5127980
4239,2023-10-14,3,3,4239000,890190,5129190
4240,2020-04-29,2,1,4240000,890400,5130400
4241,2021-02-24,3,3,4241000,890610,5131610
4242,2024-01-22,3,2,4242000,890820,5132820
4243,2022-06-27,1,2,4243000,891030,5134030
4244,2020-01-06,2,3,4244000,891240,5135240
4245,2020-12-23,1,3,4245000,891450,5136450
4246,2023-08-30,1,2,4246000,891660,5137660
4247,2022-05-05,1,1,4247000,891870,5138870
4248,2023-07-23,1,3,4248000,892080,5140080
4249,2022-02-16,3,1,4249000,892290,5141290
4250,2023-11-11,2,1,4250000,892500,5142500
4251,2021-04-21,2,2,4251000,892710,5143710
4252,2020-02-21,2,2,4252000,892920,5144920
4253,2020-12-26,2,3,4253000,893130,5146130
4254,2022-01-16,2,2,4254000,893340,5147340
4255,2020-05-21,3,2,4255000,893550,5148550
4256,2022-05-02,1,3,4256000,893760,5149760
4257,2021-07-19,2,1,4257000,893970,5150970
4258,2022-03-29,1,1,4258000,894180,5152180
4259,2022-09-25,3,3,4259000,894390,5153390
4260,2021-02-11,1,1,4260000,894600,5154600
4261,2023-06-10,3,3,4261000,894810,5155810
4262,2024-10-31,3,2,4262000,895020,5157020
4263,2023-08-20,3,1,4263000,895230,5158230
4264,2022-12-04,2,1,4264000,895440,5159440
4265,2022-08-04,2,2,4265000,895650,5160650
4266,2021-03-30,1,3,4266000,895860,5161860
4267,2022-11-14,1,3,4267000,896070,5163070
4268,2021-10-25,2,3,4268000,896280,5164280
4269,2024-12-25,2,2,4269000,896490,5165490
4270,2023-04-22,3,3,4270000,896700,5166700
4271,2023-06-13,1,1,4271000,896910,5167910
4272,2022-03-23,2,1,4272000,897120,5169120
4273,2022-03-14,1,3,4273000,897330,5170330
4274,2021-02-07,2,2,4274000,897540,5171540
4275,2022-09-02,2,1,4275000,897750,5172750
4276,2020-06-06,2,2,4276000,897960,5173960
4277,2024-01-01,3,2,4277000,898170,5175170
4278,2024-12-15,1,2,4278000,898380,5176380
4279,2022-11-06,1,2,4279000,898590,5177590
4280,2021-12-05,2,2,4280000,898800,5178800
4281,2024-08-05,2,1,4281000,899010,5180010
4282,2022-04-08,3,1,4282000,899220,5181220
4283,2023-06-19,1,1,4283000,899430,5182430
4284,2024-11-16,1,3,4284000,899640,5183640
4285,2022-11-15,1,2,4285000,899850,5184850
4286,2021-08-07,3,2,4286000,900060,5186060
4287,2024-11-04,2,2,4287000,900270,5187270
4288,2020-07-26,3,2,4288000,900480,5188480
4289,2023-03-30,1,2,4289000,900690,5189690
4290,2022-12-16,2,2,4290000,900900,5190900
4291,2020-08-29,2,1,4291000,901110,5192110
4292,2023-08-31,3,1,4292000,901320,5193320
4293,2022-04-10,2,1,4293000,901530,5194530
4294,2023-05-24,1,1,4294000,901740,5195740
4295,2024-08-17,2,2,4295000,901950,5196950
4296,2022-03-25,2,2,4296000,902160,5198160
4297,2020-07-08,1,3,4297000,902370,5199370
4298,2023-08-05,2,1,4298000,902580,5200580
4299,2020-06-03,1,3,4299000,902790,5201790
4300,2022-05-17,3,3,4300000,903000,5203000
4301,2021-05-31,1,3,4301000,903210,5204210
4302,2022-10-19,3,3,4302000,903420,5205420
4303,2020-03-22,1,2,4303000,903630,5206630
4304,2023-04-14,1,3,4304000,903840,5207840
4305,2022-02-07,3,3,4305000,904050,5209050
4306,2020-08-03,2,3,4306000,904260,5210260
4307,2022-05-23,3,2,4307000,904470,5211470
4308,2023-04-19,1,1,4308000,904680,5212680
4309,2022-10-30,1,2,4309000,904890,5213890
4310,2020-10-11,3,3,4310000,905100,5215100
4311,2024-05-13,3,1,4311000,905310,5216310
4312,2020-10-10,2,3,4312000,905520,5217520
4313,2024-05-06,2,2,4313000,905730,5218730
4314,2023-05-02,3,1,4314000,905940,5219940
4315,2023-06-02,3,1,4315000,906150,5221150
4316,2020-01-02,3,3,4316000,906360,5222360
4317,2020-03-29,2,2,4317000,906570,5223570
4318,2022-10-22,1,1,4318000,906780,5224780
4319,2024-10-06,1,1,4319000,906990,5225990
4320,2020-07-25,3,1,4320000,907200,5227200
4321,2023-05-15,2,1,4321000,907410,5228410
4322,2024-08-26,3,1,4322000,907620,5229620
4323,2024-06-13,1,1,4323000,907830,5230830
4324,2023-09-22,3,2,4324000,908040,5232040
4325,2021-07-12,2,3,4325000,908250,5233250
4326,2021-10-17,1,1,4326000,908460,5234460
4327,2024-06-07,1,1,4327000,908670,5235670
4328,2020-07-04,1,3,4328000,908880,5236880
4329,2022-05-17,1,1,4329000,909090,5238090
4330,2022-03-21,1,2,4330000,909300,5239300
4331,2021-01-16,1,3,4331000,909510,5240510
4332,2023-04-22,2,3,4332000,909720,5241720
4333,2024-02-16,2,2,4333000,909930,5242930
4334,2020-07-14,3,3,4334000,910140,5244140
4335,2024-05-14,2,2,4335000,910350,5245350
4336,2022-04-13,2,3,4336000,910560,5246560
4337,2023-06-18,3,2,4337000,910770,5247770
4338,2024-11-20,3,2,4338000,910980,5248980
4339,2024-09-16,3,2,4339000,911190,5250190
4340,2024-11-21,3,1,4340000,911400,5251400
4341,2022-09-19,3,1,4341000,911610,5252610
4342,2020-12-03,1,3,4342000,911820,5253820
4343,2023-03-29,3,1,4343000,912030,5255030
4344,2020-02-21,1,3,4344000,912240,5256240
4345,2023-02-24,3,3,4345000,912450,5257450
4346,2023-02-23,1,2,4346000,912660,5258660
4347,2023-01-14,3,2,4347000,912870,5259870
4348,2024-10-14,2,1,4348000,913080,5261080
4349,2023-08-18,2,1,4349000,913290,5262290
4350,2024-12-14,3,1,4350000,913500,5263500
4351,2022-08-15,2,2,4351000,913710,5264710
4352,2021-05-24,1,2,4352000,913920,5265920
4353,2021-08-12,2,2,4353000,914130,5267130
4354,2021-06-01,1,3,4354000,914340,5268340
4355,2021-11-22,3,1,4355000,914550,5269550
4356,2020-01-30,2,3,4356000,914760,5270760
4357,2021-05-24,3,2,4357000,914970,5271970
4358,2022-04-24,1,2,4358000,915180,5273180
4359,2023-12-21,1,2,4359000,915390,5274390
4360,2021-10-29,2,2,4360000,915600,5275600
4361,2022-07-18,2,1,4361000,915810,5276810
4362,2024-02-25,1,1,4362000,916020,5278020
4363,2020-03-09,1,1,4363000,916230,5279230
4364,2024-04-30,1,2,4364000,916440,5280440
4365,2022-04-29,3,2,4365000,916650,5281650
4366,2021-02-03,3,3,4366000,916860,5282860
4367,2023-12-09,3,2,4367000,917070,5284070
4368,2024-12-19,3,1,4368000,917280,5285280
4369,2021-05-11,1,3,4369000,917490,5286490
4370,2021-01-02,2,2,4370000,917700,5287700
4371,2023-11-24,3,1,4371000,917910,5288910
4372,2023-08-15,1,1,4372000,918120,5290120
4373,2023-06-13,1,3,4373000,918330,5291330
4374,2020-08-25,2,1,4374000,918540,5292540
4375,2022-01-25,1,1,4375000,918750,5293750
4376,2021-12-22,1,3,4376000,918960,5294960
4377,2021-01-30,1,3,4377000,919170,5296170
4378,2023-12-04,2,2,4378000,919380,5297380
4379,2022-05-07,3,3,4379000,919590,5298590
4380,2022-10-06,2,1,4380000,919800,5299800
4381,2023-12-13,1,3,4381000,920010,5301010
4382,2023-09-06,2,2,4382000,920220,5302220
4383,2023-06-15,3,1,4383000,920430,5303430
4384,2020-02-23,3,2,4384000,920640,5304640
4385,2020-01-20,2,3,4385000,920850,5305850
4386,2023-04-30,2,2,4386000,921060,5307060
4387,2020-12-16,2,3,4387000,921270,5308270
4388,2020-06-17,1,2,4388000,921480,5309480
4389,2020-10-06,3,3,4389000,921690,5310690
4390,2020-02-17,3,1,4390000,921900,5311900
4391,2021-11-01,1,3,4391000,922110,5313110
4392,2023-01-28,1,3,4392000,922320,5314320
4393,2020-06-25,2,1,4393000,922530,5315530
4394,2021-11-01,3,2,4394000,922740,5316740
4395,2021-12-19,3,1,4395000,922950,5317950
4396,2023-04-17,1,3,4396000,923160,5319160
4397,2021-09-25,3,2,4397000,923370,5320370
4398,2024-04-17,3,2,4398000,923580,5321580
4399,2021-05-22,3,2,4399000,923790,5322790
4400,2021-01-08,3,3,4400000,924000,5324000
4401,2022-03-09,3,1,4401000,924210,5325210
4402,2024-09-22,3,1,4402000,924420,5326420
4403,2022-07-02,1,3,4403000,924630,5327630
4404,2023-05-29,2,2,4404000,924840,5328840
4405,2020-08-19,2,3,4405000,925050,5330050
4406,2024-08-14,1,1,4406000,925260,5331260
4407,2022-03-27,2,3,4407000,925470,5332470
4408,2023-05-12,2,2,4408000,925680,5333680
4409,2021-01-26,3,1,4409000,925890,5334890
4410,2023-01-10,3,2,4410000,926100,5336100
4411,2020-07-04,3,2,4411000,926310,5337310
4412,2024-11-19,2,2,4412000,926520,5338520
4413,2021-09-02,1,2,4413000,926730,5339730
4414,2022-01-16,1,3,4414000,926940,5340940
4415,2022-04-25,1,3,4415000,927150,5342150
4416,2023-02-27,2,3,4416000,927360,5343360
4417,2023-09-16,1,1,4417000,927570,5344570
4418,2023-09-16,3,1,4418000,927780,5345780
4419,2020-12-16,1,2,4419000,927990,5346990
4420,2024-01-26,3,3,4420000,928200,5348200
4421,2021-10-26,1,1,4421000,928410,5349410
4422,2023-01-23,1,1,4422000,928620,5350620
4423,2024-07-13,1,1,4423000,928830,5351830
4424,2023-08-19,2,3,4424000,929040,5353040
4425,2021-05-06,1,1,4425000,929250,5354250
4426,2024-08-25,2,2,4426000,929460,5355460
4427,2023-12-31,3,1,4427000,929670,5356670
4428,2024-02-02,1,2,4428000,929880,5357880
4429,2021-06-25,2,2,4429000,930090,5359090
4430,2020-12-11,2,2,4430000,930300,5360300
4431,2021-04-03,2,2,4431000,930510,5361510
4432,2023-09-25,1,3,4432000,930720,5362720
4433,2021-06-08,2,2,4433000,930930,5363930
4434,2024-05-10,1,2,4434000,931140,5365140
4435,2021-11-09,1,3,4435000,931350,5366350
4436,2022-07-29,2,3,4436000,931560,5367560
4437,2021-10-26,2,1,4437000,931770,5368770
4438,2022-12-19,1,2,4438000,931980,5369980
4439,2023-07-27,1,3,4439000,932190,5371190
4440,2022-05-18,2,3,4440000,932400,5372400
4441,2020-05-29,2,2,4441000,932610,5373610
4442,2020-06-23,1,3,4442000,932820,5374820
4443,2024-04-10,1,3,4443000,933030,5376030
4444,2023-02-03,3,1,4444000,933240,5377240
4445,2021-07-20,3,2,4445000,933450,5378450
4446,2022-02-06,2,3,4446000,933660,5379660
4447,2023-06-21,2,1,4447000,933870,5380870
4448,2020-02-16,2,1,4448000,934080,5382080
4449,2023-10-28,2,1,4449000,934290,5383290
4450,2020-04-29,3,2,4450000,934500,5384500
4451,2023-07-17,1,2,4451000,934710,5385710
4452,2022-05-21,1,2,4452000,934920,5386920
4453,2020-07-22,3,1,4453000,935130,5388130
4454,2024-02-18,2,3,4454000,935340,5389340
4455,2023-11-04,2,2,4455000,935550,5390550
4456,2022-09-11,3,3,4456000,935760,5391760
4457,2021-05-17,3,2,4457000,935970,5392970
4458,2020-02-06,3,3,4458000,936180,5394180
4459,2021-11-17,1,2,4459000,936390,5395390
4460,2021-03-14,2,2,4460000,936600,5396600
4461,2020-03-14,3,3,4461000,936810,5397810
4462,2020-05-09,1,1,4462000,937020,5399020
4463,2023-06-22,3,3,4463000,937230,5400230
4464,2023-09-06,3,2,4464000,937440,5401440
4465,2023-10-04,2,2,4465000,937650,5402650
4466,2021-07-26,2,3,4466000,937860,5403860
4467,2022-02-23,1,3,4467000,938070,5405070
4468,2024-01-08,3,3,4468000,938280,5406280
4469,2023-04-02,1,2,4469000,938490,5407490
4470,2023-12-16,1,2,4470000,938700,5408700
4471,2020-09-11,1,3,4471000,938910,5409910
4472,2021-07-23,1,1,4472000,939120,5411120
4473,2021-07-15,2,1,4473000,939330,5412330
4474,2021-05-28,3,3,4474000,939540,5413540
4475,2021-06-17,2,2,4475000,939750,5414750
4476,2024-04-22,2,2,4476000,939960,5415960
4477,2020-06-25,2,2,4477000,940170,5417170
4478,2023-07-12,2,2,4478000,940380,5418380
4479,2021-06-14,2,1,4479000,940590,5419590
4480,2021-03-07,2,3,4480000,940800,5420800
4481,2021-04-19,2,3,4481000,941010,5422010
4482,2022-06-01,2,2,4482000,941220,5423220
4483,2020-07-19,3,1,4483000,941430,5424430
4484,2020-08-08,1,2,4484000,941640,5425640
4485,2020-04-10,3,1,4485000,941850,5426850
4486,2021-09-16,1,1,4486000,942060,5428060
4487,2024-01-21,1,2,4487000,942270,5429270
4488,2020-07-17,2,2,4488000,942480,5430480
4489,2024-01-02,1,3,4489000,942690,5431690
4490,2021-06-20,3,1,4490000,942900,5432900
4491,2022-06-02,2,3,4491000,943110,5434110
4492,2021-02-27,1,2,4492000,943320,5435320
4493,2023-09-02,2,1,4493000,943530,5436530
4494,2022-09-16,3,2,4494000,943740,5437740
4495,2023-06-06,1,1,4495000,943950,5438950
4496,2020-02-28,1,2,4496000,944160,5440160
4497,2024-06-03,3,1,4497000,944370,5441370
4498,2023-11-07,3,3,4498000,944580,5442580
4499,2023-01-22,3,3,4499000,944790,5443790
4500,2020-01-25,2,1,4500000,945000,5445000
4501,2024-07-22,1,3,4501000,945210,5446210
4502,2020-05-16,2,1,4502000,945420,5447420
4503,2023-07-28,3,2,4503000,945630,5448630
4504,2024-07-29,3,1,4504000,945840,5449840
4505,2024-11-02,3,2,4505000,946050,5451050
4506,2021-12-19,3,1,4506000,946260,5452260
4507,2024-04-15,2,2,4507000,946470,5453470
4508,2020-04-22,3,3,4508000,946680,5454680
4509,2020-06-27,3,1,4509000,946890,5455890
4510,2020-01-28,1,2,4510000,947100,5457100
4511,2022-10-01,2,2,4511000,947310,5458310
4512,2020-04-19,2,1,4512000,947520,5459520
4513,2023-01-26,3,2,4513000,947730,5460730
4514,2022-04-18,3,3,4514000,947940,5461940
4515,2023-09-20,1,2,4515000,948150,5463150
4516,2024-04-24,2,2,4516000,948360,5464360
4517,2020-04-26,3,1,4517000,948570,5465570
4518,2021-03-13,2,3,4518000,948780,5466780
4519,2021-09-25,2,1,4519000,948990,5467990
4520,2020-07-18,1,2,4520000,949200,5469200
4521,2020-08-18,2,2,4521000,949410,5470410
4522,2022-05-19,3,3,4522000,949620,5471620
4523,2023-10-17,3,3,4523000,949830,5472830
4524,2023-09-08,3,2,4524000,950040,5474040
4525,2022-09-19,3,1,4525000,950250,5475250
4526,2024-11-07,1,2,4526000,950460,5476460
4527,2020-11-23,1,2,4527000,950670,5477670
4528,2022-12-13,3,3,4528000,950880,5478880
4529,2023-08-22,2,1,4529000,951090,5480090
4530,2021-11-01,2,2,4530000,951300,5481300
4531,2022-08-20,3,1,4531000,951510,5482510
4532,2023-05-28,2,3,4532000,951720,5483720
4533,2022-09-02,2,1,4533000,951930,5484930
4534,2021-04-02,2,1,4534000,952140,5486140
4535,2022-05-07,1,2,4535000,952350,5487350
4536,2024-03-07,2,2,4536000,952560,5488560
4537,2021-12-06,1,2,4537000,952770,5489770
4538,2022-10-02,2,2,4538000,952980,5490980
4539,2024-07-11,3,2,4539000,953190,5492190
4540,2023-04-30,2,2,4540000,953400,5493400
4541,2024-06-06,2,2,4541000,953610,5494610
4542,2020-05-31,1,1,4542000,953820,5495820
4543,2022-08-08,2,2,4543000,954030,5497030
4544,2021-10-29,1,3,4544000,954240,5498240
4545,2021-07-15,3,3,4545000,954450,5499450
4546,2021-08-19,1,1,4546000,954660,5500660
4547,2020-08-17,3,2,4547000,954870,5501870
4548,2023-04-17,1,3,4548000,955080,5503080
4549,2020-03-23,2,2,4549000,955290,5504290
4550,2022-05-25,2,1,4550000,955500,5505500
4551,2023-07-11,2,2,4551000,955710,5506710
4552,2022-02-05,2,1,4552000,955920,5507920
4553,2023-07-16,1,3,4553000,956130,5509130
4554,2021-09-28,3,1,4554000,956340,5510340
4555,2024-11-20,3,3,4555000,956550,5511550
4556,2024-02-15,3,3,4556000,956760,5512760
4557,2020-02-21,2,2,4557000,956970,5513970
4558,2023-11-28,2,3,4558000,957180,5515180
4559,2023-02-17,1,2,4559000,957390,5516390
4560,2022-10-13,2,3,4560000,957600,5517600
4561,2024-11-15,3,2,4561000,957810,5518810
4562,2024-09-15,1,1,4562000,958020,5520020
4563,2021-09-08,3,3,4563000,958230,5521230
4564,2022-06-10,1,1,4564000,958440,5522440
4565,2024-02-01,3,2,4565000,958650,5523650
4566,2023-06-08,1,3,4566000,958860,5524860
4567,2024-12-25,2,2,4567000,959070,5526070
4568,2022-02-22,2,3,4568000,959280,5527280
4569,2024-08-21,1,3,4569000,959490,5528490
4570,2023-02-08,3,3,4570000,959700,5529700
4571,2021-06-19,1,3,4571000,959910,5530910
4572,2023-07-10,3,2,4572000,960120,5532120
4573,2022-08-29,1,2,4573000,960330,5533330
4574,2020-08-30,2,1,4574000,960540,5534540
4575,2024-04-30,3,1,4575000,960750,5535750
4576,2024-03-04,1,3,4576000,960960,5536960
4577,2020-05-09,1,1,4577000,961170,5538170
4578,2023-10-24,2,3,4578000,961380,5539380
4579,2022-06-13,2,1,4579000,961590,5540590
4580,2021-03-15,1,1,4580000,961800,5541800
4581,2021-05-31,3,3,4581000,962010,5543010
4582,2022-06-06,3,3,4582000,962220,5544220
4583,2024-12-23,3,3,4583000,962430,5545430
4584,2024-04-25,1,1,4584000,962640,5546640
4585,2022-06-22,3,1,4585000,962850,5547850
4586,2024-04-14,1,3,4586000,963060,5549060
4587,2022-12-09,1,2,4587000,963270,5550270
4588,2024-06-05,3,1,4588000,963480,5551480
4589,2022-12-11,2,2,4589000,963690,5552690
4590,2021-09-24,3,2,4590000,963900,5553900
4591,2021-11-13,2,3,4591000,964110,5555110
4592,2020-06-25,3,2,4592000,964320,5556320
4593,2024-12-06,2,3,4593000,964530,5557530
4594,2023-10-01,1,1,4594000,964740,5558740
4595,2023-05-20,3,2,4595000,964950,5559950
4596,2023-09-29,3,3,4596000,965160,5561160
4597,2020-09-01,3,2,4597000,965370,5562370
4598,2022-12-27,3,1,4598000,965580,5563580
4599,2020-08-09,1,1,4599000,965790,5564790
4600,2022-02-03,3,1,4600000,966000,5566000
4601,2021-04-09,2,1,4601000,966210,5567210
4602,2021-02-19,2,2,4602000,966420,5568420
4603,2024-09-08,3,3,4603000,966630,5569630
4604,2023-01-10,2,2,4604000,966840,5570840
4605,2024-05-02,2,3,4605000,967050,5572050
4606,2021-06-03,2,2,4606000,967260,5573260
4607,2023-03-21,2,2,4607000,967470,5574470
4608,2024-04-25,1,3,4608000,967680,5575680
4609,2022-01-11,3,2,4609000,967890,5576890
4610,2021-09-19,1,1,4610000,968100,5578100
4611,2023-07-14,3,3,4611000,968310,5579310
4612,2020-08-11,1,3,4612000,968520,5580520
4613,2024-03-10,2,3,4613000,968730,5581730
4614,2024-03-14,3,3,4614000,968940,5582940
4615,2023-08-20,2,1,4615000,969150,5584150
4616,2021-10-10,1,2,4616000,969360,5585360
4617,2021-04-27,1,2,4617000,969570,5586570
4618,2021-11-12,2,2,4618000,969780,5587780
4619,2022-03-01,2,3,4619000,969990,5588990
4620,2024-08-27,3,2,4620000,970200,5590200
4621,2020-09-28,2,3,4621000,970410,5591410
4622,2022-01-18,2,2,4622000,970620,5592620
4623,2023-01-16,3,3,4623000,970830,5593830
4624,2021-02-17,1,3,4624000,971040,5595040
4625,2024-03-16,3,2,4625000,971250,5596250
4626,2022-03-30,1,2,4626000,971460,5597460
4627,2022-11-19,1,1,4627000,971670,5598670
4628,2022-02-10,2,1,4628000,971880,5599880
4629,2024-06-03,3,1,4629000,972090,5601090
4630,2023-12-25,2,3,4630000,972300,5602300
4631,2024-10-04,1,2,4631000,972510,5603510
4632,2020-11-18,1,1,4632000,972720,5604720
4633,2024-07-18,1,3,4633000,972930,5605930
4634,2024-12-14,3,2,4634000,973140,5607140
4635,2021-12-13,2,2,4635000,973350,5608350
4636,2024-06-20,2,2,4636000,973560,5609560
4637,2023-08-16,2,1,4637000,973770,5610770
4638,2022-02-22,3,1,4638000,973980,5611980
4639,2021-01-29,2,3,4639000,974190,5613190
4640,2024-03-22,2,2,4640000,974400,5614400
4641,2020-07-26,1,3,4641000,974610,5615610
4642,2024-05-19,3,3,4642000,974820,5616820
4643,2023-05-20,1,1,4643000,975030,5618030
4644,2023-12-16,2,3,4644000,975240,5619240
4645,2021-06-08,1,3,4645000,975450,5620450
4646,2023-04-29,1,2,4646000,975660,5621660
4647,2024-03-24,1,1,4647000,975870,5622870
4648,2023-12-20,2,3,4648000,976080,5624080
4649,2024-03-07,2,3,4649000,976290,5625290
4650,2023-06-11,1,1,4650000,976500,5626500
4651,2024-03-06,2,1,4651000,976710,5627710
4652,2020-10-13,2,2,4652000,976920,5628920
4653,2021-01-30,3,1,4653000,977130,5630130
4654,2024-12-13,1,2,4654000,977340,5631340
4655,2023-01-25,1,2,4655000,977550,5632550
4656,2024-12-14,3,2,4656000,977760,5633760
4657,2022-04-26,2,1,4657000,977970,5634970
4658,2024-02-13,3,3,4658000,978180,5636180
4659,2024-01-08,2,3,4659000,978390,5637390
4660,2024-05-03,2,2,4660000,978600,5638600
4661,2023-12-11,3,2,4661000,978810,5639810
4662,2024-11-20,2,2,4662000,979020,5641020
4663,2021-10-09,1,1,4663000,979230,5642230
4664,2021-10-09,3,1,4664000,979440,5643440
4665,2020-02-11,1,3,4665000,979650,5644650
4666,2023-12-10,2,2,4666000,979860,5645860
4667,2023-03-09,2,2,4667000,980070,5647070
4668,2021-05-11,2,2,4668000,980280,5648280
4669,2021-07-28,3,2,4669000,980490,5649490
4670,2020-03-02,1,2,4670000,980700,5650700
4671,2021-11-03,1,3,4671000,980910,5651910
4672,2020-11-22,1,2,4672000,981120,5653120
4673,2022-06-28,1,2,4673000,981330,5654330
4674,2022-02-22,3,3,4674000,981540,5655540
4675,2020-08-28,3,2,4675000,981750,5656750
4676,2022-01-08,1,3,4676000,981960,5657960
4677,2020-03-31,1,1,4677000,982170,5659170
4678,2023-07-05,3,3,4678000,982380,5660380
4679,2020-09-28,2,3,4679000,982590,5661590
4680,2021-08-16,3,1,4680000,982800,5662800
4681,2022-05-05,1,2,4681000,983010,5664010
4682,2021-05-29,2,1,4682000,983220,5665220
4683,2020-02-27,2,1,4683000,983430,5666430
4684,2023-06-06,1,2,4684000,983640,5667640
4685,2023-01-17,1,3,4685000,983850,5668850
4686,2024-04-07,2,1,4686000,984060,5670060
4687,2022-08-11,3,3,4687000,984270,5671270
4688,2021-10-23,3,1,4688000,984480,5672480
4689,2024-05-27,2,1,4689000,984690,5673690
4690,2023-05-06,3,3,4690000,984900,5674900
4691,2020-04-05,1,3,4691000,985110,5676110
4692,2024-09-05,3,3,4692000,985320,5677320
4693,2023-07-02,3,1,4693000,985530,5678530
4694,2020-08-06,1,1,4694000,985740,5679740
4695,2024-12-06,1,2,4695000,985950,5680950
4696,2020-10-20,1,1,4696000,986160,5682160
4697,2023-01-25,3,2,4697000,986370,5683370
4698,2021-10-23,3,2,4698000,986580,5684580
4699,2020-04-04,3,1,4699000,986790,5685790
4700,2023-03-19,2,2,4700000,987000,5687000
4701,2023-11-20,1,1,4701000,987210,5688210
4702,2024-06-01,3,3,4702000,987420,5689420
4703,2024-03-27,3,1,4703000,987630,5690630
4704,2021-03-26,2,3,4704000,987840,5691840
4705,2020-10-10,1,2,4705000,988050,5693050
4706,2021-08-16,3,1,4706000,988260,5694260
4707,2022-05-07,1,3,4707000,988470,5695470
4708,2022-04-04,3,3,4708000,988680,5696680
4709,2024-12-02,1,2,4709000,988890,5697890
4710,2023-08-11,3,3,4710000,989100,5699100
4711,2020-02-16,3,3,4711000,989310,5700310
4712,2021-01-22,2,1,4712000,989520,5701520
4713,2020-05-09,3,1,4713000,989730,5702730
4714,2023-04-24,2,3,4714000,989940,5703940
4715,2022-03-22,1,2,4715000,990150,5705150
4716,2022-12-31,1,1,4716000,990360,5706360
4717,2024-11-11,3,1,4717000,990570,5707570
4718,2022-01-07,2,1,4718000,990780,5708780
4719,2024-01-03,3,3,4719000,990990,5709990
4720,2023-04-05,1,2,4720000,991200,5711200
4721,2022-07-10,1,3,4721000,991410,5712410
4722,2022-10-06,1,1,4722000,991620,5713620
4723,2024-08-12,1,1,4723000,991830,5714830
4724,2022-02-01,3,2,4724000,992040,5716040
4725,2024-06-11,3,3,4725000,992250,5717250
4726,2020-11-23,3,3,4726000,992460,5718460
4727,2021-08-10,2,1,4727000,992670,5719670
4728,2024-08-28,1,1,4728000,992880,5720880
4729,2024-02-08,2,2,4729000,993090,5722090
4730,2021-05-24,2,1,4730000,993300,5723300
4731,2021-11-25,1,1,4731000,993510,5724510
4732,2021-05-07,1,1,4732000,993720,5725720
4733,2023-06-07,1,3,4733000,993930,5726930
4734,2021-11-10,2,3,4734000,994140,5728140
4735,2024-06-18,2,1,4735000,994350,5729350
4736,2023-04-01,3,3,4736000,994560,5730560
4737,2022-02-07,3,1,4737000,994770,5731770
4738,2020-12-29,1,3,4738000,994980,5732980
4739,2021-10-05,1,1,4739000,995190,5734190
4740,2022-11-23,3,3,4740000,995400,5735400
4741,2022-11-24,1,3,4741000,995610,5736610
4742,2020-12-21,1,2,4742000,995820,5737820
4743,2021-01-07,3,2,4743000,996030,5739030
4744,2020-08-19,1,3,4744000,996240,5740240
4745,2020-09-24,2,2,4745000,996450,5741450
4746,2024-05-25,1,2,4746000,996660,5742660
4747,2020-03-18,3,1,4747000,996870,5743870
4748,2021-11-22,1,2,4748000,997080,5745080
4749,2020-03-12,2,2,4749000,997290,5746290
4750,2024-12-21,2,1,4750000,997500,5747500
4751,2022-05-06,3,2,4751000,997710,5748710
4752,2022-05-13,2,3,4752000,997920,5749920
4753,2021-11-02,1,2,4753000,998130,5751130
4754,2021-11-21,1,3,4754000,998340,5752340
4755,2022-03-29,2,3,4755000,998550,5753550
4756,2022-01-18,1,2,4756000,998760,5754760
4757,2021-07-19,3,2,4757000,998970,5755970
4758,2024-02-05,1,2,4758000,999180,5757180
4759,2022-10-11,2,3,4759000,999390,5758390
4760,2021-12-14,3,2,4760000,999600,5759600
4761,2020-07-08,1,3,4761000,999810,5760810
4762,2023-06-28,1,3,4762000,1000020,5762020
4763,2020-07-18,1,2,4763000,1000230,5763230
4764,2023-11-02,3,2,4764000,1000440,5764440
4765,2022-01-07,2,1,4765000,1000650,5765650
4766,2020-01-18,3,2,4766000,1000860,5766860
4767,2020-09-17,3,2,4767000,1001070,5768070
4768,2022-10-21,1,2,4768000,1001280,5769280
4769,2022-05-07,3,2,4769000,1001490,5770490
4770,2020-12-01,1,3,4770000,1001700,5771700
4771,2020-03-10,2,1,4771000,1001910,5772910
4772,2023-05-02,2,1,4772000,1002120,5774120
4773,2021-06-02,1,1,4773000,1002330,5775330
4774,2020-11-27,3,3,4774000,1002540,5776540
4775,2024-10-23,3,1,4775000,1002750,5777750
4776,2022-04-10,1,3,4776000,1002960,5778960
4777,2024-02-22,2,3,4777000,1003170,5780170
4778,2020-03-25,2,2,4778000,1003380,5781380
4779,2022-03-06,2,3,4779000,1003590,5782590
4780,2020-10-18,3,1,4780000,1003800,5783800
4781,2024-03-14,2,1,4781000,1004010,5785010
4782,2020-11-01,3,2,4782000,1004220,5786220
4783,2023-10-05,3,1,4783000,1004430,5787430
4784,2021-06-17,2,1,4784000,1004640,5788640
4785,2021-07-15,2,2,4785000,1004850,5789850
4786,2021-11-20,2,2,4786000,1005060,5791060
4787,2023-05-10,2,3,4787000,1005270,5792270
4788,2022-10-22,1,1,4788000,1005480,5793480
4789,2023-03-05,3,2,4789000,1005690,5794690
4790,2022-09-07,1,2,4790000,1005900,5795900
4791,2024-02-23,2,3,4791000,1006110,5797110
4792,2021-04-11,1,2,4792000,1006320,5798320
4793,2021-11-01,1,3,4793000,1006530,5799530
4794,2023-06-21,1,2,4794000,1006740,5800740
4795,2020-04-09,2,1,4795000,1006950,5801950
4796,2023-02-01,2,1,4796000,1007160,5803160
4797,2022-10-07,2,3,4797000,1007370,5804370
4798,2024-02-04,1,3,4798000,1007580,5805580
4799,2020-02-13,2,3,4799000,1007790,5806790
4800,2022-06-18,3,3,4800000,1008000,5808000
4801,2022-03-07,3,2,4801000,1008210,5809210
4802,2020-10-27,2,3,4802000,1008420,5810420
4803,2020-05-08,1,2,4803000,1008630,5811630
4804,2023-07-26,2,3,4804000,1008840,5812840
4805,2021-10-13,3,3,4805000,1009050,5814050
4806,2024-08-25,1,2,4806000,1009260,5815260
4807,2020-11-04,1,1,4807000,1009470,5816470
4808,2023-02-14,1,2,4808000,1009680,5817680
4809,2021-05-07,3,3,4809000,1009890,5818890
4810,2022-12-04,1,2,4810000,1010100,5820100
4811,2024-05-31,1,1,4811000,1010310,5821310
4812,2020-01-18,3,3,4812000,1010520,5822520
4813,2022-04-24,1,2,4813000,1010730,5823730
4814,2020-05-24,1,3,4814000,1010940,5824940
4815,2023-12-03,1,3,4815000,1011150,5826150
4816,2023-06-17,3,2,4816000,1011360,5827360
4817,2021-01-02,1,3,4817000,1011570,5828570
4818,2021-09-11,1,3,4818000,1011780,5829780
4819,2023-04-03,1,1,4819000,1011990,5830990
4820,2022-08-07,1,2,4820000,1012200,5832200
4821,2024-03-05,1,1,4821000,1012410,5833410
4822,2022-03-29,2,3,4822000,1012620,5834620
4823,2020-11-28,2,1,4823000,1012830,5835830
4824,2020-01-26,2,1,4824000,1013040,5837040
4825,2023-08-05,2,3,4825000,1013250,5838250
4826,2021-09-25,2,2,4826000,1013460,5839460
4827,2024-11-02,2,2,4827000,1013670,5840670
4828,2024-04-12,1,3,4828000,1013880,5841880
4829,2023-12-14,3,3,4829000,1014090,5843090
4830,2023-03-23,2,1,4830000,1014300,5844300
4831,2024-06-11,3,1,4831000,1014510,5845510
4832,2020-06-19,1,1,4832000,1014720,5846720
4833,2021-02-25,3,2,4833000,1014930,5847930
4834,2023-12-23,1,2,4834000,1015140,5849140
4835,2022-06-27,2,3,4835000,1015350,5850350
4836,2023-09-13,1,1,4836000,1015560,5851560
4837,2022-06-01,2,1,4837000,1015770,5852770
4838,2020-10-07,1,2,4838000,1015980,5853980
4839,2021-10-11,2,1,4839000,1016190,5855190
4840,2020-03-05,1,3,4840000,1016400,5856400
4841,2020-04-18,1,3,4841000,1016610,5857610
4842,2023-12-10,1,2,4842000,1016820,5858820
4843,2023-08-25,1,3,4843000,1017030,5860030
4844,2024-03-18,1,1,4844000,1017240,5861240
4845,2022-05-16,3,2,4845000,1017450,5862450
4846,2020-11-23,3,3,4846000,1017660,5863660
4847,2022-06-18,1,3,4847000,1017870,5864870
4848,2023-10-24,2,2,4848000,1018080,5866080
4849,2021-04-04,3,3,4849000,1018290,5867290
4850,2022-03-19,3,3,4850000,1018500,5868500
4851,2020-07-19,1,2,4851000,1018710,5869710
4852,2024-07-03,3,3,4852000,1018920,5870920
4853,2023-08-06,1,1,4853000,1019130,5872130
4854,2023-07-05,2,3,4854000,1019340,5873340
4855,2024-05-10,3,3,4855000,1019550,5874550
4856,2023-01-13,1,1,4856000,1019760,5875760
4857,2022-04-18,2,3,4857000,1019970,5876970
4858,2024-04-17,2,1,4858000,1020180,5878180
4859,2021-04-06,2,2,4859000,1020390,5879390
4860,2024-08-07,2,3,4860000,1020600,5880600
4861,2020-02-03,2,2,4861000,1020810,5881810
4862,2024-11-09,1,2,4862000,1021020,5883020
4863,2020-07-04,2,2,4863000,1021230,5884230
4864,2023-02-19,2,2,4864000,1021440,5885440
4865,2021-01-09,2,2,4865000,1021650,5886650
4866,2021-02-12,1,2,4866000,1021860,5887860
4867,2022-03-20,3,1,4867000,1022070,5889070
4868,2022-04-07,3,3,4868000,1022280,5890280
4869,2022-08-06,3,2,4869000,1022490,5891490
4870,2023-05-09,1,3,4870000,1022700,5892700
4871,2022-12-09,3,2,4871000,1022910,5893910
4872,2020-08-09,2,3,4872000,1023120,5895120
4873,2021-10-20,1,1,4873000,1023330,5896330
4874,2022-12-30,2,2,4874000,1023540,5897540
4875,2020-06-03,2,2,4875000,1023750,5898750
4876,2021-11-26,2,1,4876000,1023960,5899960
4877,2023-02-26,3,3,4877000,1024170,5901170
4878,2023-02-12,2,2,4878000,1024380,5902380
4879,2023-10-02,2,1,4879000,1024590,5903590
4880,2020-12-31,3,3,4880000,1024800,5904800
4881,2022-08-01,2,1,4881000,1025010,5906010
4882,2022-10-11,3,2,4882000,1025220,5907220
4883,2022-04-16,3,3,4883000,1025430,5908430
4884,2020-11-05,1,2,4884000,1025640,5909640
4885,2024-12-02,1,2,4885000,1025850,5910850
4886,2022-12-17,1,3,4886000,1026060,5912060
4887,2024-12-09,1,1,4887000,1026270,5913270
4888,2021-04-16,2,3,4888000,1026480,5914480
4889,2020-10-14,1,1,4889000,1026690,5915690
4890,2020-03-06,3,2,4890000,1026900,5916900
4891,2021-08-23,2,2,4891000,1027110,5918110
4892,2020-12-17,2,3,4892000,1027320,5919320
4893,2023-03-17,2,3,4893000,1027530,5920530
4894,2020-11-23,1,1,4894000,1027740,5921740
4895,2022-05-20,2,1,4895000,1027950,5922950
4896,2023-03-30,2,3,4896000,1028160,5924160
4897,2021-07-13,3,3,4897000,1028370,5925370
4898,2024-07-12,2,3,4898000,1028580,5926580
4899,2020-08-10,2,1,4899000,1028790,5927790
4900,2021-11-22,2,2,4900000,1029000,5929000
4901,2022-09-16,3,2,4901000,1029210,5930210
4902,2024-01-18,1,1,4902000,1029420,5931420
4903,2024-03-15,1,1,4903000,1029630,5932630
4904,2020-11-23,1,3,4904000,1029840,5933840
4905,2021-01-22,2,2,4905000,1030050,5935050
4906,2021-11-20,1,3,4906000,1030260,5936260
4907,2021-12-21,2,2,4907000,1030470,5937470
4908,2020-12-14,3,3,4908000,1030680,5938680
4909,2023-02-24,2,3,4909000,1030890,5939890
4910,2020-08-08,1,1,4910000,1031100,5941100
4911,2020-05-08,2,1,4911000,1031310,5942310
4912,2020-01-14,2,1,4912000,1031520,5943520
4913,2021-06-01,1,1,4913000,1031730,5944730
4914,2022-07-15,1,1,4914000,1031940,5945940
4915,2021-07-11,2,1,4915000,1032150,5947150
4916,2024-06-21,3,3,4916000,1032360,5948360
4917,2024-05-27,3,3,4917000,1032570,5949570
4918,2022-06-10,3,2,4918000,1032780,5950780
4919,2021-09-16,1,1,4919000,1032990,5951990
4920,2023-12-20,3,1,4920000,1033200,5953200
4921,2024-05-02,3,3,4921000,1033410,5954410
4922,2022-09-13,2,3,4922000,1033620,5955620
4923,2022-11-04,1,3,4923000,1033830,5956830
4924,2024-03-08,3,3,4924000,1034040,5958040
4925,2022-08-30,2,3,4925000,1034250,5959250
4926,2021-12-09,2,3,4926000,1034460,5960460
4927,2024-05-07,1,3,4927000,1034670,5961670
4928,2023-09-16,2,2,4928000,1034880,5962880
4929,2022-01-15,3,1,4929000,1035090,5964090
4930,2023-01-14,3,1,4930000,1035300,5965300
4931,2020-09-20,1,2,4931000,1035510,5966510
4932,2021-05-07,2,2,4932000,1035720,5967720
4933,2020-08-27,2,2,4933000,1035930,5968930
4934,2022-09-25,2,1,4934000,1036140,5970140
4935,2020-01-15,1,3,4935000,1036350,5971350
4936,2020-05-24,3,1,4936000,1036560,5972560
4937,2023-03-11,3,1,4937000,1036770,5973770
4938,2023-09-24,2,2,4938000,1036980,5974980
4939,2023-03-14,1,1,4939000,1037190,5976190
4940,2024-02-14,2,3,4940000,1037400,5977400
4941,2021-09-29,1,2,4941000,1037610,5978610
4942,2024-10-07,3,1,4942000,1037820,5979820
4943,2024-01-21,3,1,4943000,1038030,5981030
4944,2022-01-30,3,2,4944000,1038240,5982240
4945,2023-04-10,1,1,4945000,1038450,5983450
4946,2022-12-23,1,2,4946000,1038660,5984660
4947,2021-04-04,2,1,4947000,1038870,5985870
4948,2024-10-04,3,2,4948000,1039080,5987080
4949,2024-06-02,1,1,4949000,1039290,5988290
4950,2020-08-26,3,2,4950000,1039500,5989500
4951,2024-02-05,3,3,4951000,1039710,5990710
4952,2023-11-25,2,1,4952000,1039920,5991920
4953,2024-09-19,1,2,4953000,1040130,5993130
4954,2024-02-04,2,1,4954000,1040340,5994340
4955,2024-11-07,3,3,4955000,1040550,5995550
4956,2023-11-22,1,3,4956000,1040760,5996760
4957,2023-09-10,2,3,4957000,1040970,5997970
4958,2022-01-18,3,3,4958000,1041180,5999180
4959,2024-02-10,2,3,4959000,1041390,6000390
4960,2022-05-14,1,2,4960000,1041600,6001600
4961,2021-07-21,1,1,4961000,1041810,6002810
4962,2020-09-05,2,3,4962000,1042020,6004020
4963,2023-07-04,3,1,4963000,1042230,6005230
4964,2023-12-05,1,2,4964000,1042440,6006440
4965,2022-04-18,1,2,4965000,1042650,6007650
4966,2023-11-29,3,3,4966000,1042860,6008860
4967,2024-10-20,1,2,4967000,1043070,6010070
4968,2020-12-23,1,1,4968000,1043280,6011280
4969,2022-01-08,2,3,4969000,1043490,6012490
4970,2022-01-01,3,3,4970000,1043700,6013700
4971,2020-01-08,1,1,4971000,1043910,6014910
4972,2022-03-13,1,2,4972000,1044120,6016120
4973,2023-07-09,1,2,4973000,1044330,6017330
4974,2023-09-26,1,1,4974000,1044540,6018540
4975,2020-05-17,2,3,4975000,1044750,6019750
4976,2022-09-04,1,2,4976000,1044960,6020960
4977,2021-06-28,3,2,4977000,1045170,6022170
4978,2020-11-11,3,2,4978000,1045380,6023380
4979,2020-10-05,3,1,4979000,1045590,6024590
4980,2020-07-13,1,1,4980000,1045800,6025800
4981,2023-07-03,1,2,4981000,1046010,6027010
4982,2022-05-05,2,2,4982000,1046220,6028220
4983,2022-08-14,2,3,4983000,1046430,6029430
4984,2021-04-28,3,3,4984000,1046640,6030640
4985,2023-04-16,1,3,4985000,1046850,6031850
4986,2024-06-07,1,3,4986000,1047060,6033060
4987,2024-11-01,2,3,4987000,1047270,6034270
4988,2023-06-30,1,1,4988000,1047480,6035480
4989,2022-06-19,1,2,4989000,1047690,6036690
4990,2024-05-05,1,3,4990000,1047900,6037900
4991,2023-12-15,3,1,4991000,1048110,6039110
4992,2023-11-11,3,1,4992000,1048320,6040320
4993,2023-11-22,1,1,4993000,1048530,6041530
4994,2021-02-09,3,1,4994000,1048740,6042740
4995,2021-09-22,1,3,4995000,1048950,6043950
4996,2020-02-16,3,3,4996000,1049160,6045160
4997,2022-08-10,3,2,4997000,1049370,6046370
4998,2020-09-29,3,1,4998000,1049580,6047580
4999,2020-07-03,3,3,4999000,1049790,6048790
5000,2023-06-22,3,3,5000000,1050000,6050000
5001,2021-09-06,2,2,5001000,1050210,6051210
5002,2023-08-10,1,1,5002000,1050420,6052420
5003,2022-04-26,2,3,5003000,1050630,6053630
5004,2022-11-29,3,2,5004000,1050840,6054840
5005,2024-07-27,2,2,5005000,1051050,6056050
5006,2023-09-26,1,2,5006000,1051260,6057260
5007,2021-01-11,1,2,5007000,1051470,6058470
5008,2022-03-19,1,3,5008000,1051680,6059680
5009,2021-06-21,2,2,5009000,1051890,6060890
5010,2020-03-27,1,2,5010000,1052100,6062100
5011,2024-04-11,3,3,5011000,1052310,6063310
5012,2023-08-20,1,3,5012000,1052520,6064520
5013,2023-10-30,3,2,5013000,1052730,6065730
5014,2023-04-23,1,2,5014000,1052940,6066940
5015,2024-10-25,3,1,5015000,1053150,6068150
5016,2023-03-07,3,3,5016000,1053360,6069360
5017,2022-06-25,2,3,5017000,1053570,6070570
5018,2020-06-04,1,2,5018000,1053780,6071780
5019,2023-12-24,3,3,5019000,1053990,6072990
5020,2020-05-20,2,3,5020000,1054200,6074200
5021,2022-06-07,2,2,5021000,1054410,6075410
5022,2022-06-08,1,2,5022000,1054620,6076620
5023,2020-11-29,1,1,5023000,1054830,6077830
5024,2021-11-10,3,2,5024000,1055040,6079040
5025,2024-05-29,2,2,5025000,1055250,6080250
5026,2021-01-04,3,2,5026000,1055460,6081460
5027,2022-07-13,1,2,5027000,1055670,6082670
5028,2020-01-28,2,3,5028000,1055880,6083880
5029,2021-11-08,1,1,5029000,1056090,6085090
5030,2024-10-23,1,3,5030000,1056300,6086300
5031,2022-02-02,2,1,5031000,1056510,6087510
5032,2021-11-02,2,1,5032000,1056720,6088720
5033,2024-10-31,1,2,5033000,1056930,6089930
5034,2022-09-22,3,3,5034000,1057140,6091140
5035,2021-11-28,2,3,5035000,1057350,6092350
5036,2021-07-02,2,3,5036000,1057560,6093560
5037,2021-07-21,3,1,5037000,1057770,6094770
5038,2022-07-09,2,3,5038000,1057980,6095980
5039,2024-10-07,2,3,5039000,1058190,6097190
5040,2021-05-09,3,2,5040000,1058400,6098400
5041,2022-10-26,1,1,5041000,1058610,6099610
5042,2023-01-06,3,2,5042000,1058820,6100820
5043,2023-08-05,2,1,5043000,1059030,6102030
5044,2022-12-05,1,3,5044000,1059240,6103240
5045,2022-08-31,2,2,5045000,1059450,6104450
5046,2021-04-06,1,3,5046000,1059660,6105660
5047,2021-07-17,2,2,5047000,1059870,6106870
5048,2022-10-21,2,2,5048000,1060080,6108080
5049,2022-12-18,2,1,5049000,1060290,6109290
5050,2024-02-03,2,3,5050000,1060500,6110500
5051,2022-12-25,1,1,5051000,1060710,6111710
5052,2020-08-17,2,3,5052000,1060920,6112920
5053,2022-08-26,1,2,5053000,1061130,6114130
5054,2024-09-12,2,2,5054000,1061340,6115340
5055,2024-07-15,1,3,5055000,1061550,6116550
5056,2023-11-02,2,3,5056000,1061760,6117760
5057,2022-06-23,3,3,5057000,1061970,6118970
5058,2021-11-07,3,2,5058000,1062180,6120180
5059,2024-04-07,2,1,5059000,1062390,6121390
5060,2020-05-02,2,3,5060000,1062600,6122600
5061,2021-09-30,1,2,5061000,1062810,6123810
5062,2023-11-09,2,3,5062000,1063020,6125020
5063,2024-03-11,1,3,5063000,1063230,6126230
5064,2024-06-23,3,2,5064000,1063440,6127440
5065,2024-12-01,3,1,5065000,1063650,6128650
5066,2023-05-04,2,2,5066000,1063860,6129860
5067,2023-04-05,3,3,5067000,1064070,6131070
5068,2023-05-25,1,3,5068000,1064280,6132280
5069,2021-12-20,1,1,5069000,1064490,6133490
5070,2023-11-13,3,2,5070000,1064700,6134700
5071,2020-09-13,2,3,5071000,1064910,6135910
5072,2021-06-28,1,2,5072000,1065120,6137120
5073,2023-01-16,2,3,5073000,1065330,6138330
5074,2024-10-17,2,1,5074000,1065540,6139540
5075,2024-09-03,2,3,5075000,1065750,6140750
5076,2024-08-24,2,2,5076000,1065960,6141960
5077,2023-10-22,1,1,5077000,1066170,6143170
5078,2022-12-16,2,3,5078000,1066380,6144380
5079,2022-02-24,2,2,5079000,1066590,6145590
5080,2024-09-09,2,2,5080000,1066800,6146800
5081,2020-06-24,2,1,5081000,1067010,6148010
5082,2023-08-29,2,3,5082000,1067220,6149220
5083,2020-01-06,3,3,5083000,1067430,6150430
5084,2021-04-14,1,2,5084000,1067640,6151640
5085,2020-12-02,1,2,5085000,1067850,6152850
5086,2024-08-31,3,1,5086000,1068060,6154060
5087,2022-04-15,2,2,5087000,1068270,6155270
5088,2023-03-05,3,2,5088000,1068480,6156480
5089,2022-10-09,3,2,5089000,1068690,6157690
5090,2021-05-03,2,2,5090000,1068900,6158900
5091,2020-10-28,2,2,5091000,1069110,6160110
5092,2020-11-25,1,1,5092000,1069320,6161320
5093,2020-05-07,2,3,5093000,1069530,6162530
5094,2020-12-12,3,3,5094000,1069740,6163740
5095,2020-02-03,3,2,5095000,1069950,6164950
5096,2024-01-31,3,1,5096000,1070160,6166160
5097,2023-06-08,3,3,5097000,1070370,6167370
5098,2024-08-12,2,3,5098000,1070580,6168580
5099,2023-01-18,2,3,5099000,1070790,6169790
5100,2021-04-20,3,3,5100000,1071000,6171000
5101,2022-07-20,3,3,5101000,1071210,6172210
5102,2020-03-14,3,2,5102000,1071420,6173420
5103,2022-09-01,3,1,5103000,1071630,6174630
5104,2023-03-21,2,3,5104000,1071840,6175840
5105,2023-06-13,3,3,5105000,1072050,6177050
5106,2020-11-04,2,2,5106000,1072260,6178260
5107,2024-06-05,1,1,5107000,1072470,6179470
5108,2021-10-04,1,2,5108000,1072680,6180680
5109,2020-12-07,1,3,5109000,1072890,6181890
5110,2023-07-17,2,1,5110000,1073100,6183100
5111,2022-05-27,3,3,5111000,1073310,6184310
5112,2020-02-26,3,1,5112000,1073520,6185520
5113,2020-02-01,2,1,5113000,1073730,6186730
5114,2023-11-17,1,1,5114000,1073940,6187940
5115,2024-12-21,1,2,5115000,1074150,6189150
5116,2023-01-18,3,3,5116000,1074360,6190360
5117,2023-05-21,3,1,5117000,1074570,6191570
5118,2024-04-11,2,2,5118000,1074780,6192780
5119,2023-10-26,3,3,5119000,1074990,6193990
5120,2024-04-04,2,1,5120000,1075200,6195200
5121,2023-10-31,2,1,5121000,1075410,6196410
5122,2021-09-23,3,2,5122000,1075620,6197620
5123,2022-11-13,2,2,5123000,1075830,6198830
5124,2022-12-29,3,3,5124000,1076040,6200040
5125,2024-02-14,1,2,5125000,1076250,6201250
5126,2023-05-23,2,2,5126000,1076460,6202460
5127,2023-11-30,2,2,5127000,1076670,6203670
5128,2020-10-08,1,2,5128000,1076880,6204880
5129,2024-09-20,1,2,5129000,1077090,6206090
5130,2022-03-30,1,3,5130000,1077300,6207300
5131,2024-01-26,1,1,5131000,1077510,6208510
5132,2023-11-19,1,2,5132000,1077720,6209720
5133,2022-04-29,1,3,5133000,1077930,6210930
5134,2020-06-27,3,1,5134000,1078140,6212140
5135,2022-12-23,2,2,5135000,1078350,6213350
5136,2023-03-22,1,2,5136000,1078560,6214560
5137,2020-05-04,1,1,5137000,1078770,6215770
5138,2020-10-15,1,1,5138000,1078980,6216980
5139,2022-06-28,1,2,5139000,1079190,6218190
5140,2024-08-14,2,1,5140000,1079400,6219400
5141,2020-12-04,3,2,5141000,1079610,6220610
5142,2024-02-05,1,1,5142000,1079820,6221820
5143,2021-09-16,2,3,5143000,1080030,6223030
5144,2024-09-26,2,3,5144000,1080240,6224240
5145,2021-01-25,1,3,5145000,1080450,6225450
5146,2020-10-06,3,1,5146000,1080660,6226660
5147,2021-03-28,1,2,5147000,1080870,6227870
5148,2024-05-05,2,2,5148000,1081080,6229080
5149,2024-04-07,3,3,5149000,1081290,6230290
5150,2022-10-19,3,3,5150000,1081500,6231500
5151,2021-04-16,1,1,5151000,1081710,6232710
5152,2020-04-25,2,3,5152000,1081920,6233920
5153,2021-09-14,1,2,5153000,1082130,6235130
5154,2023-03-21,3,2,5154000,1082340,6236340
5155,2022-08-20,2,1,5155000,1082550,6237550
5156,2023-12-16,3,3,5156000,1082760,6238760
5157,2020-08-11,3,3,5157000,1082970,6239970
5158,2021-09-24,2,2,5158000,1083180,6241180
5159,2020-04-11,1,3,5159000,1083390,6242390
5160,2024-07-19,1,2,5160000,1083600,6243600
5161,2021-07-04,3,2,5161000,1083810,6244810
5162,2022-07-16,2,2,5162000,1084020,6246020
5163,2020-12-31,3,1,5163000,1084230,6247230
5164,2021-08-08,3,3,5164000,1084440,6248440
5165,2022-09-10,3,2,5165000,1084650,6249650
5166,2022-10-26,1,1,5166000,1084860,6250860
5167,2021-06-09,2,2,5167000,1085070,6252070
5168,2023-10-02,2,3,5168000,1085280,6253280
5169,2024-07-11,2,1,5169000,1085490,6254490
5170,2024-06-04,2,3,5170000,1085700,6255700
5171,2020-03-19,1,1,5171000,1085910,6256910
5172,2023-04-12,2,2,5172000,1086120,6258120
5173,2024-03-02,2,3,5173000,1086330,6259330
5174,2021-03-16,3,1,5174000,1086540,6260540
5175,2022-07-24,3,1,5175000,1086750,6261750
5176,2022-08-03,1,1,5176000,1086960,6262960
5177,2021-07-17,1,2,5177000,1087170,6264170
5178,2020-10-14,1,1,5178000,1087380,6265380
5179,2021-12-18,3,1,5179000,1087590,6266590
5180,2020-03-19,2,2,5180000,1087800,6267800
5181,2022-12-09,2,3,5181000,1088010,6269010
5182,2024-12-23,3,1,5182000,1088220,6270220
5183,2020-09-22,3,3,5183000,1088430,6271430
5184,2024-09-15,3,1,5184000,1088640,6272640
5185,2020-04-27,1,1,5185000,1088850,6273850
5186,2021-01-26,1,3,5186000,1089060,6275060
5187,2021-09-10,2,3,5187000,1089270,6276270
5188,2022-08-25,2,3,5188000,1089480,6277480
5189,2021-06-17,2,2,5189000,1089690,6278690
5190,2022-04-06,1,2,5190000,1089900,6279900
5191,2022-11-12,2,2,5191000,1090110,6281110
5192,2023-08-03,3,3,5192000,1090320,6282320
5193,2020-04-18,2,2,5193000,1090530,6283530
5194,2020-11-02,1,1,5194000,1090740,6284740
5195,2022-03-28,1,3,5195000,1090950,6285950
5196,2022-03-23,2,2,5196000,1091160,6287160
5197,2021-03-27,1,3,5197000,1091370,6288370
5198,2020-03-01,3,1,5198000,1091580,6289580
5199,2020-07-29,3,2,5199000,1091790,6290790
5200,2021-10-17,1,1,5200000,1092000,6292000
5201,2020-04-15,1,3,5201000,1092210,6293210
5202,2024-10-08,3,3,5202000,1092420,6294420
5203,2023-07-28,2,3,5203000,1092630,6295630
5204,2020-08-26,2,3,5204000,1092840,6296840
5205,2023-01-22,1,3,5205000,1093050,6298050
5206,2023-09-05,2,1,5206000,1093260,6299260
5207,2024-10-27,2,2,5207000,1093470,6300470
5208,2021-01-02,2,3,5208000,1093680,6301680
5209,2020-11-29,2,2,5209000,1093890,6302890
5210,2023-03-10,1,3,5210000,1094100,6304100
5211,2024-02-21,1,2,5211000,1094310,6305310
5212,2021-04-14,1,3,5212000,1094520,6306520
5213,2022-07-22,1,1,5213000,1094730,6307730
5214,2021-06-04,3,1,5214000,1094940,6308940
5215,2023-12-07,1,1,5215000,1095150,6310150
5216,2022-12-27,2,3,5216000,1095360,6311360
5217,2020-11-08,3,3,5217000,1095570,6312570
5218,2020-01-04,2,2,5218000,1095780,6313780
5219,2024-12-06,1,1,5219000,1095990,6314990
5220,2021-05-28,2,1,5220000,1096200,6316200
5221,2024-07-20,1,3,5221000,1096410,6317410
5222,2023-10-07,1,2,5222000,1096620,6318620
5223,2023-07-08,2,1,5223000,1096830,6319830
5224,2022-05-08,1,2,5224000,1097040,6321040
5225,2023-10-20,1,3,5225000,1097250,6322250
5226,2021-04-05,3,3,5226000,1097460,6323460
5227,2024-06-22,2,3,5227000,1097670,6324670
5228,2021-12-24,3,2,5228000,1097880,6325880
5229,2022-01-31,2,3,5229000,1098090,6327090
5230,2020-11-27,3,2,5230000,1098300,6328300
5231,2021-11-07,3,3,5231000,1098510,6329510
5232,2023-12-14,2,1,5232000,1098720,6330720
5233,2020-08-13,3,3,5233000,1098930,6331930
5234,2020-01-24,1,2,5234000,1099140,6333140
5235,2022-01-23,1,2,5235000,1099350,6334350
5236,2023-11-09,3,3,5236000,1099560,6335560
5237,2023-04-06,1,2,5237000,1099770,6336770
5238,2021-11-02,1,2,5238000,1099980,6337980
5239,2024-06-24,3,3,5239000,1100190,6339190
5240,2021-03-28,3,3,5240000,1100400,6340400
5241,2022-08-22,3,1,5241000,1100610,6341610
5242,2020-04-15,3,1,5242000,1100820,6342820
5243,2020-10-22,3,3,5243000,1101030,6344030
5244,2021-02-07,3,2,5244000,1101240,6345240
5245,2022-08-12,2,1,5245000,1101450,6346450
5246,2024-02-05,1,1,5246000,1101660,6347660
5247,2021-02-15,1,1,5247000,1101870,6348870
5248,2023-02-02,3,2,5248000,1102080,6350080
5249,2020-08-31,1,1,5249000,1102290,6351290
5250,2023-12-27,2,2,5250000,1102500,6352500
5251,2020-03-24,2,2,5251000,1102710,6353710
5252,2023-12-27,1,2,5252000,1102920,6354920
5253,2020-04-05,1,1,5253000,1103130,6356130
5254,2020-04-05,2,3,5254000,1103340,6357340
5255,2024-02-16,2,3,5255000,1103550,6358550
5256,2024-11-05,2,2,5256000,1103760,6359760
5257,2020-09-09,3,2,5257000,1103970,6360970
5258,2020-05-17,1,2,5258000,1104180,6362180
5259,2024-12-21,3,3,5259000,1104390,6363390
5260,2024-11-20,3,3,5260000,1104600,6364600
5261,2021-01-11,2,2,5261000,1104810,6365810
5262,2021-01-18,1,1,5262000,1105020,6367020
5263,2022-09-22,1,3,5263000,1105230,6368230
5264,2022-03-20,2,1,5264000,1105440,6369440
5265,2022-12-20,2,1,5265000,1105650,6370650
5266,2021-11-08,3,3,5266000,1105860,6371860
5267,2021-03-15,3,2,5267000,1106070,6373070
5268,2020-02-03,2,2,5268000,1106280,6374280
5269,2023-10-30,2,1,5269000,1106490,6375490
5270,2024-05-12,3,1,5270000,1106700,6376700
5271,2024-04-30,1,1,5271000,1106910,6377910
5272,2023-06-25,3,2,5272000,1107120,6379120
5273,2020-02-25,3,1,5273000,1107330,6380330
5274,2022-09-07,1,2,5274000,1107540,6381540
5275,2024-08-22,2,2,5275000,1107750,6382750
5276,2024-06-30,3,2,5276000,1107960,6383960
5277,2021-03-17,2,1,5277000,1108170,6385170
5278,2020-01-04,1,2,5278000,1108380,6386380
5279,2021-01-26,1,3,5279000,1108590,6387590
5280,2024-12-06,2,1,5280000,1108800,6388800
5281,2023-10-15,3,1,5281000,1109010,6390010
5282,2024-04-09,1,3,5282000,1109220,6391220
5283,2020-10-07,2,1,5283000,1109430,6392430
5284,2024-02-11,2,3,5284000,1109640,6393640
5285,2020-07-19,1,2,5285000,1109850,6394850
5286,2020-01-15,2,1,5286000,1110060,6396060
5287,2021-09-03,1,2,5287000,1110270,6397270
5288,2023-10-31,2,2,5288000,1110480,6398480
5289,2022-01-16,3,1,5289000,1110690,6399690
5290,2023-11-09,1,3,5290000,1110900,6400900
5291,2022-06-27,3,1,5291000,1111110,6402110
5292,2023-05-28,1,3,5292000,1111320,6403320
5293,2022-06-22,1,2,5293000,1111530,6404530
5294,2023-11-24,2,2,5294000,1111740,6405740
5295,2024-06-23,1,1,5295000,1111950,6406950
5296,2022-09-03,2,3,5296000,1112160,6408160
5297,2020-10-02,1,3,5297000,1112370,6409370
5298,2023-03-18,2,2,5298000,1112580,6410580
5299,2020-07-20,1,1,5299000,1112790,6411790
5300,2021-01-31,2,2,5300000,1113000,6413000
5301,2024-02-05,1,1,5301000,1113210,6414210
5302,2021-04-12,3,1,5302000,1113420,6415420
5303,2020-12-11,2,3,5303000,1113630,6416630
5304,2020-09-19,3,3,5304000,1113840,6417840
5305,2022-03-01,1,1,5305000,1114050,6419050
5306,2023-07-23,3,1,5306000,1114260,6420260
5307,2023-06-09,3,3,5307000,1114470,6421470
5308,2021-10-31,2,3,5308000,1114680,6422680
5309,2023-02-18,3,3,5309000,1114890,6423890
5310,2021-03-04,2,2,5310000,1115100,6425100
5311,2022-06-06,2,2,5311000,1115310,6426310
5312,2022-02-10,3,2,5312000,1115520,6427520
5313,2021-10-04,1,2,5313000,1115730,6428730
5314,2021-01-23,2,2,5314000,1115940,6429940
5315,2020-07-14,1,3,5315000,1116150,6431150
5316,2022-03-13,3,1,5316000,1116360,6432360
5317,2023-05-28,3,1,5317000,1116570,6433570
5318,2024-12-26,1,3,5318000,1116780,6434780
5319,2020-02-10,3,2,5319000,1116990,6435990
5320,2024-03-31,2,1,5320000,1117200,6437200
5321,2021-06-10,3,1,5321000,1117410,6438410
5322,2022-02-24,2,1,5322000,1117620,6439620
5323,2021-05-01,2,1,5323000,1117830,6440830
5324,2020-09-19,3,3,5324000,1118040,6442040
5325,2023-02-13,3,2,5325000,1118250,6443250
5326,2022-12-09,2,1,5326000,1118460,6444460
5327,2024-11-24,3,1,5327000,1118670,6445670
5328,2021-04-15,3,1,5328000,1118880,6446880
5329,2021-07-20,3,3,5329000,1119090,6448090
5330,2022-07-25,1,3,5330000,1119300,6449300
5331,2021-05-17,3,2,5331000,1119510,6450510
5332,2024-08-10,3,1,5332000,1119720,6451720
5333,2023-03-07,2,1,5333000,1119930,6452930
5334,2023-03-23,3,1,5334000,1120140,6454140
5335,2022-06-15,1,2,5335000,1120350,6455350
5336,2021-06-04,1,3,5336000,1120560,6456560
5337,2020-05-15,3,3,5337000,1120770,6457770
5338,2021-09-08,2,1,5338000,1120980,6458980
5339,2020-05-19,1,1,5339000,1121190,6460190
5340,2024-12-22,2,2,5340000,1121400,6461400
5341,2020-01-17,2,1,5341000,1121610,6462610
5342,2023-08-26,3,1,5342000,1121820,6463820
5343,2023-05-08,3,3,5343000,1122030,6465030
5344,2022-05-01,3,3,5344000,1122240,6466240
5345,2023-09-29,2,3,5345000,1122450,6467450
5346,2020-01-06,1,3,5346000,1122660,6468660
5347,2023-02-11,3,2,5347000,1122870,6469870
5348,2022-12-08,2,2,5348000,1123080,6471080
5349,2020-07-24,2,3,5349000,1123290,6472290
5350,2021-12-08,2,1,5350000,1123500,6473500
5351,2024-01-31,1,2,5351000,1123710,6474710
5352,2022-09-24,3,1,5352000,1123920,6475920
5353,2021-06-08,3,2,5353000,1124130,6477130
5354,2020-03-25,2,3,5354000,1124340,6478340
5355,2020-07-14,1,3,5355000,1124550,6479550
5356,2020-05-16,2,3,5356000,1124760,6480760
5357,2021-06-06,3,3,5357000,1124970,6481970
5358,2020-05-24,3,3,5358000,1125180,6483180
5359,2022-11-27,2,3,5359000,1125390,6484390
5360,2022-07-05,1,3,5360000,1125600,6485600
5361,2024-02-23,3,1,5361000,1125810,6486810
5362,2021-08-23,1,3,5362000,1126020,6488020
5363,2024-03-16,2,2,5363000,1126230,6489230
5364,2024-03-26,2,3,5364000,1126440,6490440
5365,2023-05-28,3,2,5365000,1126650,6491650
5366,2022-04-23,2,2,5366000,1126860,6492860
5367,2023-12-08,3,1,5367000,1127070,6494070
5368,2021-06-05,1,1,5368000,1127280,6495280
5369,2020-03-29,3,1,5369000,1127490,6496490
5370,2022-04-28,2,3,5370000,1127700,6497700
5371,2023-02-17,2,2,5371000,1127910,6498910
5372,2023-02-28,1,3,5372000,1128120,6500120
5373,2023-10-19,1,1,5373000,1128330,6501330
5374,2022-01-06,1,1,5374000,1128540,6502540
5375,2021-11-22,2,2,5375000,1128750,6503750
5376,2020-06-30,2,3,5376000,1128960,6504960
5377,2022-05-17,2,2,5377000,1129170,6506170
5378,2020-03-04,3,3,5378000,1129380,6507380
5379,2024-07-09,1,3,5379000,1129590,6508590
5380,2023-01-18,3,2,5380000,1129800,6509800
5381,2024-06-15,2,3,5381000,1130010,6511010
5382,2024-05-20,2,2,5382000,1130220,6512220
5383,2021-01-17,1,2,5383000,1130430,6513430
5384,2020-12-20,2,1,5384000,1130640,6514640
5385,2020-02-03,2,2,5385000,1130850,6515850
5386,2021-01-18,3,1,5386000,1131060,6517060
5387,2023-09-27,2,1,5387000,1131270,6518270
5388,2023-02-11,2,3,5388000,1131480,6519480
5389,2022-08-11,1,1,5389000,1131690,6520690
5390,2020-07-16,2,2,5390000,1131900,6521900
5391,2022-05-19,3,2,5391000,1132110,6523110
5392,2021-02-17,1,3,5392000,1132320,6524320
5393,2020-07-06,2,1,5393000,1132530,6525530
5394,2020-06-23,1,3,5394000,1132740,6526740
5395,2024-01-30,1,1,5395000,1132950,6527950
5396,2021-06-01,3,2,5396000,1133160,6529160
5397,2021-09-29,2,3,5397000,1133370,6530370
5398,2024-06-23,1,1,5398000,1133580,6531580
5399,2021-01-19,1,3,5399000,1133790,6532790
5400,2021-09-19,2,3,5400000,1134000,6534000
5401,2022-07-07,3,1,5401000,1134210,6535210
5402,2024-08-08,1,1,5402000,1134420,6536420
5403,2020-03-14,3,1,5403000,1134630,6537630
5404,2020-09-11,3,2,5404000,1134840,6538840
5405,2024-01-02,2,3,5405000,1135050,6540050
5406,2021-05-23,1,1,5406000,1135260,6541260
5407,2022-02-07,2,2,5407000,1135470,6542470
5408,2022-01-23,1,2,5408000,1135680,6543680
5409,2023-04-30,1,1,5409000,1135890,6544890
5410,2020-06-14,1,3,5410000,1136100,6546100
5411,2021-08-04,1,3,5411000,1136310,6547310
5412,2020-06-23,3,2,5412000,1136520,6548520
5413,2022-04-03,2,3,5413000,1136730,6549730
5414,2024-08-10,3,2,5414000,1136940,6550940
5415,2024-08-28,1,2,5415000,1137150,6552150
5416,2022-01-25,1,1,5416000,1137360,6553360
5417,2020-09-05,3,2,5417000,1137570,6554570
5418,2022-10-05,3,1,5418000,1137780,6555780
5419,2020-12-27,1,2,5419000,1137990,6556990
5420,2024-10-08,2,1,5420000,1138200,6558200
5421,2024-01-09,3,1,5421000,1138410,6559410
5422,2024-07-15,3,3,5422000,1138620,6560620
5423,2023-09-05,3,1,5423000,1138830,6561830
5424,2024-12-08,3,2,5424000,1139040,6563040
5425,2024-11-04,1,1,5425000,1139250,6564250
5426,2021-06-24,3,3,5426000,1139460,6565460
5427,2023-08-18,3,2,5427000,1139670,6566670
5428,2023-08-15,1,1,5428000,1139880,6567880
5429,2021-10-05,1,1,5429000,1140090,6569090
5430,2022-01-08,1,3,5430000,1140300,6570300
5431,2020-01-21,3,3,5431000,1140510,6571510
5432,2024-05-02,2,2,5432000,1140720,6572720
5433,2023-08-02,2,2,5433000,1140930,6573930
5434,2022-08-26,1,3,5434000,1141140,6575140
5435,2020-02-10,2,3,5435000,1141350,6576350
5436,2024-10-21,3,1,5436000,1141560,6577560
5437,2023-08-20,3,3,5437000,1141770,6578770
5438,2022-03-20,1,2,5438000,1141980,6579980
5439,2020-10-24,1,2,5439000,1142190,6581190
5440,2020-06-03,3,3,5440000,1142400,6582400
5441,2021-02-11,3,1,5441000,1142610,6583610
5442,2023-12-17,3,3,5442000,1142820,6584820
5443,2022-12-06,3,1,5443000,1143030,6586030
5444,2021-07-08,3,2,5444000,1143240,6587240
5445,2021-05-19,2,1,5445000,1143450,6588450
5446,2024-12-11,2,1,5446000,1143660,6589660
5447,2022-10-21,2,1,5447000,1143870,6590870
5448,2021-08-29,3,2,5448000,1144080,6592080
5449,2024-04-06,1,1,5449000,1144290,6593290
5450,2021-09-13,3,2,5450000,1144500,6594500
5451,2023-03-15,2,1,5451000,1144710,6595710
5452,2020-05-25,3,2,5452000,1144920,6596920
5453,2023-11-20,1,1,5453000,1145130,6598130
5454,2022-06-06,3,2,5454000,1145340,6599340
5455,2021-09-21,3,2,5455000,1145550,6600550
5456,2022-06-09,3,3,5456000,1145760,6601760
5457,2023-04-03,3,2,5457000,1145970,6602970
5458,2020-04-25,2,2,5458000,1146180,6604180
5459,2021-06-25,1,2,5459000,1146390,6605390
5460,2023-08-22,3,2,5460000,1146600,6606600
5461,2023-06-18,1,1,5461000,1146810,6607810
5462,2020-02-12,2,2,5462000,1147020,6609020
5463,2023-03-14,2,3,5463000,1147230,6610230
5464,2020-05-07,2,3,5464000,1147440,6611440
5465,2024-02-29,2,1,5465000,1147650,6612650
5466,2020-11-28,2,3,5466000,1147860,6613860
5467,2024-11-03,2,1,5467000,1148070,6615070
5468,2022-01-01,3,3,5468000,1148280,6616280
5469,2021-05-04,2,1,5469000,1148490,6617490
5470,2024-01-27,1,3,5470000,1148700,6618700
5471,2022-12-27,2,3,5471000,1148910,6619910
5472,2024-08-19,1,2,5472000,1149120,6621120
5473,2022-01-18,3,3,5473000,1149330,6622330
5474,2024-04-24,2,1,5474000,1149540,6623540
5475,2023-12-01,3,1,5475000,1149750,6624750
5476,2021-09-24,2,2,5476000,1149960,6625960
5477,2023-03-17,1,1,5477000,1150170,6627170
5478,2022-12-06,1,1,5478000,1150380,6628380
5479,2023-01-23,1,1,5479000,1150590,6629590
5480,2020-02-09,2,2,5480000,1150800,6630800
5481,2021-01-18,3,3,5481000,1151010,6632010
5482,2022-12-16,1,3,5482000,1151220,6633220
5483,2022-10-28,3,3,5483000,1151430,6634430
5484,2021-03-28,2,1,5484000,1151640,6635640
5485,2020-05-07,3,2,5485000,1151850,6636850
5486,2024-04-05,1,1,5486000,1152060,6638060
5487,2021-03-01,3,3,5487000,1152270,6639270
5488,2020-12-27,2,3,5488000,1152480,6640480
5489,2024-10-05,3,1,5489000,1152690,6641690
5490,2024-01-11,2,3,5490000,1152900,6642900
5491,2020-09-05,3,3,5491000,1153110,6644110
5492,2020-08-12,3,2,5492000,1153320,6645320
5493,2021-07-23,2,1,5493000,1153530,6646530
5494,2020-01-13,1,1,5494000,1153740,6647740
5495,2023-06-25,1,2,5495000,1153950,6648950
5496,2021-08-11,1,1,5496000,1154160,6650160
5497,2022-09-23,3,3,5497000,1154370,6651370
5498,2022-05-29,3,1,5498000,1154580,6652580
5499,2021-02-18,2,3,5499000,1154790,6653790
5500,2023-07-02,2,3,5500000,1155000,6655000
5501,2021-09-09,2,1,5501000,1155210,6656210
5502,2020-05-23,3,1,5502000,1155420,6657420
5503,2024-10-16,1,1,5503000,1155630,6658630
5504,2022-05-09,3,2,5504000,1155840,6659840
5505,2020-12-20,2,1,5505000,1156050,6661050
5506,2021-02-11,1,1,5506000,1156260,6662260
5507,2024-07-19,1,2,5507000,1156470,6663470
5508,2020-02-21,2,2,5508000,1156680,6664680
5509,2021-09-25,1,3,5509000,1156890,6665890
5510,2020-02-03,3,2,5510000,1157100,6667100
5511,2023-05-08,3,2,5511000,1157310,6668310
5512,2020-01-01,3,1,5512000,1157520,6669520
5513,2021-03-24,3,1,5513000,1157730,6670730
5514,2024-02-27,2,2,5514000,1157940,6671940
5515,2024-03-02,3,2,5515000,1158150,6673150
5516,2020-01-02,3,2,5516000,1158360,6674360
5517,2022-06-10,2,1,5517000,1158570,6675570
5518,2023-01-14,2,1,5518000,1158780,6676780
5519,2020-09-08,3,2,5519000,1158990,6677990
5520,2021-09-08,2,3,5520000,1159200,6679200
5521,2024-12-08,1,2,5521000,1159410,6680410
5522,2020-01-07,1,1,5522000,1159620,6681620
5523,2022-07-16,1,2,5523000,1159830,6682830
5524,2023-02-10,2,2,5524000,1160040,6684040
5525,2022-05-13,3,3,5525000,1160250,6685250
5526,2021-05-10,2,1,5526000,1160460,6686460
5527,2024-02-16,1,1,5527000,1160670,6687670
5528,2023-05-12,3,2,5528000,1160880,6688880
5529,2024-08-06,1,2,5529000,1161090,6690090
5530,2020-07-07,1,1,5530000,1161300,6691300
5531,2024-01-08,2,1,5531000,1161510,6692510
5532,2022-04-14,3,2,5532000,1161720,6693720
5533,2024-09-19,2,3,5533000,1161930,6694930
5534,2022-12-31,1,3,5534000,1162140,6696140
5535,2024-06-29,1,2,5535000,1162350,6697350
5536,2020-08-02,2,1,5536000,1162560,6698560
5537,2024-12-23,1,3,5537000,1162770,6699770
5538,2023-09-30,2,1,5538000,1162980,6700980
5539,2020-09-20,3,3,5539000,1163190,6702190
5540,2020-08-04,3,3,5540000,1163400,6703400
5541,2023-02-15,1,1,5541000,1163610,6704610
5542,2022-10-24,2,2,5542000,1163820,6705820
5543,2020-05-10,3,1,5543000,1164030,6707030
5544,2020-11-14,2,3,5544000,1164240,6708240
5545,2022-12-17,1,1,5545000,1164450,6709450
5546,2021-01-16,3,2,5546000,1164660,6710660
5547,2024-05-18,2,1,5547000,1164870,6711870
5548,2021-05-24,3,1,5548000,1165080,6713080
5549,2023-06-23,2,3,5549000,1165290,6714290
5550,2021-03-15,3,3,5550000,1165500,6715500
5551,2021-06-04,3,3,5551000,1165710,6716710
5552,2023-08-12,3,1,5552000,1165920,6717920
5553,2021-06-25,1,1,5553000,1166130,6719130
5554,2020-10-20,2,3,5554000,1166340,6720340
5555,2020-08-07,3,3,5555000,1166550,6721550
5556,2023-04-22,3,3,5556000,1166760,6722760
5557,2020-07-03,3,2,5557000,1166970,6723970
5558,2024-07-27,2,2,5558000,1167180,6725180
5559,2022-04-07,1,3,5559000,1167390,6726390
5560,2023-11-13,1,1,5560000,1167600,6727600
5561,2023-07-16,1,2,5561000,1167810,6728810
5562,2024-03-31,2,1,5562000,1168020,6730020
5563,2020-02-10,1,3,5563000,1168230,6731230
5564,2023-12-25,3,2,5564000,1168440,6732440
5565,2021-01-25,2,1,5565000,1168650,6733650
5566,2021-06-23,2,1,5566000,1168860,6734860
5567,2024-04-28,1,1,5567000,1169070,6736070
5568,2021-11-22,2,1,5568000,1169280,6737280
5569,2022-04-14,3,3,5569000,1169490,6738490
5570,2024-02-15,2,2,5570000,1169700,6739700
5571,2021-09-23,2,1,5571000,1169910,6740910
5572,2024-11-16,2,1,5572000,1170120,6742120
5573,2022-05-25,2,3,5573000,1170330,6743330
5574,2021-09-19,1,1,5574000,1170540,6744540
5575,2024-05-01,1,3,5575000,1170750,6745750
5576,2023-05-30,2,2,5576000,1170960,6746960
5577,2021-12-20,3,3,5577000,1171170,6748170
5578,2022-07-02,1,3,5578000,1171380,6749380
5579,2021-07-03,1,2,5579000,1171590,6750590
5580,2024-10-06,1,3,5580000,1171800,6751800
5581,2024-12-24,3,1,5581000,1172010,6753010
5582,2021-04-02,3,1,5582000,1172220,6754220
5583,2022-09-18,1,2,5583000,1172430,6755430
5584,2023-01-13,2,3,5584000,1172640,6756640
5585,2021-07-06,3,3,5585000,1172850,6757850
5586,2024-12-09,2,1,5586000,1173060,6759060
5587,2020-10-07,2,3,5587000,1173270,6760270
5588,2021-08-13,2,3,5588000,1173480,6761480
5589,2021-06-25,3,3,5589000,1173690,6762690
5590,2022-12-30,3,3,5590000,1173900,6763900
5591,2023-05-12,2,3,5591000,1174110,6765110
5592,2022-10-04,3,2,5592000,1174320,6766320
5593,2023-12-01,3,2,5593000,1174530,6767530
5594,2023-04-15,1,3,5594000,1174740,6768740
5595,2020-02-03,1,1,5595000,1174950,6769950
5596,2020-11-24,1,2,5596000,1175160,6771160
5597,2021-12-27,2,3,5597000,1175370,6772370
5598,2021-09-09,2,2,5598000,1175580,6773580
5599,2020-03-09,1,3,5599000,1175790,6774790
5600,2023-09-19,1,3,5600000,1176000,6776000
5601,2021-04-20,3,3,5601000,1176210,6777210
5602,2021-04-18,2,3,5602000,1176420,6778420
5603,2024-09-24,2,3,5603000,1176630,6779630
5604,2024-10-07,1,1,5604000,1176840,6780840
5605,2024-07-02,2,2,5605000,1177050,6782050
5606,2024-06-04,3,2,5606000,1177260,6783260
5607,2023-07-21,2,1,5607000,1177470,6784470
5608,2021-09-02,1,1,5608000,1177680,6785680
5609,2024-09-27,3,3,5609000,1177890,6786890
5610,2021-09-17,3,3,5610000,1178100,6788100
5611,2022-06-23,1,3,5611000,1178310,6789310
5612,2022-04-13,2,1,5612000,1178520,6790520
5613,2023-04-15,2,3,5613000,1178730,6791730
5614,2024-06-23,1,1,5614000,1178940,6792940
5615,2022-01-17,3,3,5615000,1179150,6794150
5616,2020-10-19,2,2,5616000,1179360,6795360
5617,2020-09-17,3,3,5617000,1179570,6796570
5618,2022-07-02,2,3,5618000,1179780,6797780
5619,2023-09-16,3,3,5619000,1179990,6798990
5620,2024-06-12,3,1,5620000,1180200,6800200
5621,2021-04-12,2,2,5621000,1180410,6801410
5622,2024-05-03,1,1,5622000,1180620,6802620
5623,2023-01-20,1,2,5623000,1180830,6803830
5624,2020-05-11,2,3,5624000,1181040,6805040
5625,2022-12-24,1,3,5625000,1181250,6806250
5626,2024-10-03,3,1,5626000,1181460,6807460
5627,2024-08-24,3,2,5627000,1181670,6808670
5628,2024-04-14,3,2,5628000,1181880,6809880
5629,2020-04-05,1,2,5629000,1182090,6811090
5630,2023-12-26,2,1,5630000,1182300,6812300
5631,2021-09-16,2,2,5631000,1182510,6813510
5632,2021-01-13,2,2,5632000,1182720,6814720
5633,2021-11-07,2,2,5633000,1182930,6815930
5634,2021-01-29,1,1,5634000,1183140,6817140
5635,2024-04-26,1,1,5635000,1183350,6818350
5636,2023-06-01,1,2,5636000,1183560,6819560
5637,2024-06-04,3,1,5637000,1183770,6820770
5638,2024-01-03,2,3,5638000,1183980,6821980
5639,2020-05-12,2,2,5639000,1184190,6823190
5640,2024-03-08,1,3,5640000,1184400,6824400
5641,2023-03-06,2,3,5641000,1184610,6825610
5642,2020-01-21,3,3,5642000,1184820,6826820
5643,2021-08-14,2,3,5643000,1185030,6828030
5644,2022-06-26,2,2,5644000,1185240,6829240
5645,2020-04-23,1,3,5645000,1185450,6830450
5646,2021-07-03,2,3,5646000,1185660,6831660
5647,2022-12-10,1,2,5647000,1185870,6832870
5648,2020-09-17,1,1,5648000,1186080,6834080
5649,2024-03-05,2,2,5649000,1186290,6835290
5650,2020-10-12,3,2,5650000,1186500,6836500
5651,2024-04-05,1,2,5651000,1186710,6837710
5652,2022-09-18,2,3,5652000,1186920,6838920
5653,2024-03-19,1,2,5653000,1187130,6840130
5654,2022-01-07,3,1,5654000,1187340,6841340
5655,2022-03-04,3,3,5655000,1187550,6842550
5656,2022-05-22,2,2,5656000,1187760,6843760
5657,2024-05-06,2,1,5657000,1187970,6844970
5658,2020-01-02,2,1,5658000,1188180,6846180
5659,2023-10-29,3,3,5659000,1188390,6847390
5660,2022-10-29,1,2,5660000,1188600,6848600
5661,2022-05-13,2,3,5661000,1188810,6849810
5662,2023-01-17,1,3,5662000,1189020,6851020
5663,2024-07-24,1,2,5663000,1189230,6852230
5664,2023-10-28,3,3,5664000,1189440,6853440
5665,2020-01-31,2,2,5665000,1189650,6854650
5666,2021-11-15,1,1,5666000,1189860,6855860
5667,2020-12-30,1,3,5667000,1190070,6857070
5668,2024-05-20,2,1,5668000,1190280,6858280
5669,2023-02-03,3,1,5669000,1190490,6859490
5670,2024-10-05,3,2,5670000,1190700,6860700
5671,2020-05-06,3,3,5671000,1190910,6861910
5672,2020-04-12,2,1,5672000,1191120,6863120
5673,2020-08-02,1,1,5673000,1191330,6864330
5674,2022-03-08,1,3,5674000,1191540,6865540
5675,2021-03-15,2,2,5675000,1191750,6866750
5676,2023-10-13,3,2,5676000,1191960,6867960
5677,2023-02-06,1,1,5677000,1192170,6869170
5678,2020-10-25,1,3,5678000,1192380,6870380
5679,2024-04-20,3,2,5679000,1192590,6871590
5680,2024-05-20,3,2,5680000,1192800,6872800
5681,2024-07-21,1,2,5681000,1193010,6874010
5682,2021-03-05,3,1,5682000,1193220,6875220
5683,2023-03-10,1,2,5683000,1193430,6876430
5684,2021-01-01,2,3,5684000,1193640,6877640
5685,2023-09-02,1,3,5685000,1193850,6878850
5686,2022-02-05,1,2,5686000,1194060,6880060
5687,2020-02-09,1,2,5687000,1194270,6881270
5688,2022-09-02,1,3,5688000,1194480,6882480
5689,2022-05-14,1,3,5689000,1194690,6883690
5690,2020-03-05,2,1,5690000,1194900,6884900
5691,2020-12-20,3,1,5691000,1195110,6886110
5692,2022-03-12,2,1,5692000,1195320,6887320
5693,2021-11-15,1,1,5693000,1195530,6888530
5694,2024-10-03,2,1,5694000,1195740,6889740
5695,2023-03-18,1,3,5695000,1195950,6890950
5696,2021-08-12,3,2,5696000,1196160,6892160
5697,2024-04-21,3,3,5697000,1196370,6893370
5698,2022-07-30,1,1,5698000,1196580,6894580
5699,2023-07-28,3,3,5699000,1196790,6895790
5700,2022-02-17,3,2,5700000,1197000,6897000
5701,2024-02-17,1,1,5701000,1197210,6898210
5702,2023-02-07,2,2,5702000,1197420,6899420
5703,2023-12-10,1,3,5703000,1197630,6900630
5704,2020-01-28,1,1,5704000,1197840,6901840
5705,2020-01-30,2,2,5705000,1198050,6903050
5706,2023-03-20,1,3,5706000,1198260,6904260
5707,2020-05-14,2,3,5707000,1198470,6905470
5708,2021-08-13,3,1,5708000,1198680,6906680
5709,2024-07-30,3,3,5709000,1198890,6907890
5710,2024-05-10,3,3,5710000,1199100,6909100
5711,2021-10-09,3,1,5711000,1199310,6910310
5712,2022-07-26,3,2,5712000,1199520,6911520
5713,2022-05-01,2,2,5713000,1199730,6912730
5714,2023-11-03,3,3,5714000,1199940,6913940
5715,2023-03-21,1,1,5715000,1200150,6915150
5716,2022-01-21,2,1,5716000,1200360,6916360
5717,2024-03-18,2,3,5717000,1200570,6917570
5718,2024-06-27,2,2,5718000,1200780,6918780
5719,2020-01-05,1,3,5719000,1200990,6919990
5720,2020-12-18,2,2,5720000,1201200,6921200
5721,2022-04-19,3,1,5721000,1201410,6922410
5722,2024-01-03,1,1,5722000,1201620,6923620
5723,2023-06-04,2,1,5723000,1201830,6924830
5724,2024-02-14,2,2,5724000,1202040,6926040
5725,2024-05-29,3,1,5725000,1202250,6927250
5726,2023-06-15,3,3,5726000,1202460,6928460
5727,2022-08-03,3,1,5727000,1202670,6929670
5728,2024-01-04,3,1,5728000,1202880,6930880
5729,2021-08-23,2,3,5729000,1203090,6932090
5730,2020-03-15,2,1,5730000,1203300,6933300
5731,2023-09-30,1,2,5731000,1203510,6934510
5732,2022-01-13,2,2,5732000,1203720,6935720
5733,2021-09-04,2,1,5733000,1203930,6936930
5734,2024-05-20,3,3,5734000,1204140,6938140
5735,2023-10-15,3,2,5735000,1204350,6939350
5736,2021-01-07,1,3,5736000,1204560,6940560
5737,2021-05-16,1,2,5737000,1204770,6941770
5738,2021-11-26,1,1,5738000,1204980,6942980
5739,2024-07-03,2,2,5739000,1205190,6944190
5740,2022-03-31,2,2,5740000,1205400,6945400
5741,2024-12-26,3,2,5741000,1205610,6946610
5742,2021-11-18,1,2,5742000,1205820,6947820
5743,2022-10-08,1,1,5743000,1206030,6949030
5744,2024-04-23,2,1,5744000,1206240,6950240
5745,2022-02-08,3,2,5745000,1206450,6951450
5746,2021-02-27,3,3,5746000,1206660,6952660
5747,2020-01-07,2,3,5747000,1206870,6953870
5748,2022-04-23,1,2,5748000,1207080,6955080
5749,2021-09-14,2,1,5749000,1207290,6956290
5750,2020-08-30,1,2,5750000,1207500,6957500
5751,2023-08-04,2,1,5751000,1207710,6958710
5752,2022-07-06,3,3,5752000,1207920,6959920
5753,2022-10-11,1,2,5753000,1208130,6961130
5754,2020-03-28,1,3,5754000,1208340,6962340
5755,2020-07-01,1,1,5755000,1208550,6963550
5756,2020-02-01,1,3,5756000,1208760,6964760
5757,2021-03-20,1,2,5757000,1208970,6965970
5758,2024-06-10,1,3,5758000,1209180,6967180
5759,2021-05-25,2,2,5759000,1209390,6968390
5760,2024-11-18,1,3,5760000,1209600,6969600
5761,2021-05-09,1,2,5761000,1209810,6970810
5762,2024-07-31,1,1,5762000,1210020,6972020
5763,2022-10-16,1,3,5763000,1210230,6973230
5764,2023-10-15,2,1,5764000,1210440,6974440
5765,2021-06-10,2,1,5765000,1210650,6975650
5766,2023-10-06,2,1,5766000,1210860,6976860
5767,2021-12-05,1,2,5767000,1211070,6978070
5768,2024-06-18,1,3,5768000,1211280,6979280
5769,2021-11-10,2,3,5769000,1211490,6980490
5770,2021-08-06,2,3,5770000,1211700,6981700
5771,2022-06-09,1,2,5771000,1211910,6982910
5772,2022-02-25,1,2,5772000,1212120,6984120
5773,2023-11-18,1,3,5773000,1212330,6985330
5774,2024-10-16,3,2,5774000,1212540,6986540
5775,2021-08-31,3,1,5775000,1212750,6987750
5776,2023-10-11,3,2,5776000,1212960,6988960
5777,2020-10-07,3,3,5777000,1213170,6990170
5778,2021-09-24,1,3,5778000,1213380,6991380
5779,2021-02-03,3,1,5779000,1213590,6992590
5780,2022-06-20,1,2,5780000,1213800,6993800
5781,2022-01-18,2,1,5781000,1214010,6995010
5782,2024-07-25,2,3,5782000,1214220,6996220
5783,2024-03-22,2,2,5783000,1214430,6997430
5784,2021-10-10,1,2,5784000,1214640,6998640
5785,2024-09-27,2,2,5785000,1214850,6999850
5786,2023-04-06,3,2,5786000,1215060,7001060
5787,2021-06-30,2,3,5787000,1215270,7002270
5788,2022-09-05,3,2,5788000,1215480,7003480
5789,2021-11-13,1,2,5789000,1215690,7004690
5790,2022-02-02,1,1,5790000,1215900,7005900
5791,2022-04-07,1,1,5791000,1216110,7007110
5792,2022-08-03,2,3,5792000,1216320,7008320
5793,2022-08-27,1,2,5793000,1216530,7009530
5794,2022-10-16,1,3,5794000,1216740,7010740
5795,2023-02-08,2,1,5795000,1216950,7011950
5796,2020-10-31,1,1,5796000,1217160,7013160
5797,2021-12-04,3,1,5797000,1217370,7014370
5798,2020-03-08,2,2,5798000,1217580,7015580
5799,2022-05-17,2,3,5799000,1217790,7016790
5800,2022-07-03,3,2,5800000,1218000,7018000
5801,2023-04-24,2,3,5801000,1218210,7019210
5802,2021-09-09,3,1,5802000,1218420,7020420
5803,2024-07-20,3,3,5803000,1218630,7021630
5804,2021-04-13,1,2,5804000,1218840,7022840
5805,2020-02-15,3,3,5805000,1219050,7024050
5806,2021-01-30,1,3,5806000,1219260,7025260
5807,2022-01-03,1,1,5807000,1219470,7026470
5808,2023-06-20,2,3,5808000,1219680,7027680
5809,2021-03-26,1,2,5809000,1219890,7028890
5810,2023-04-16,3,3,5810000,1220100,7030100
5811,2024-02-08,2,3,5811000,1220310,7031310
5812,2021-11-16,1,3,5812000,1220520,7032520
5813,2023-06-18,3,1,5813000,1220730,7033730
5814,2021-05-30,2,3,5814000,1220940,7034940
5815,2024-10-29,1,3,5815000,1221150,7036150
5816,2023-03-03,1,2,5816000,1221360,7037360
5817,2021-11-20,3,1,5817000,1221570,7038570
5818,2023-07-13,1,2,5818000,1221780,7039780
5819,2020-02-24,3,2,5819000,1221990,7040990
5820,2020-05-17,1,1,5820000,1222200,7042200
5821,2021-10-22,3,3,5821000,1222410,7043410
5822,2023-01-05,2,1,5822000,1222620,7044620
5823,2024-01-02,2,2,5823000,1222830,7045830
5824,2021-03-23,2,1,5824000,1223040,7047040
5825,2020-06-16,2,1,5825000,1223250,7048250
5826,2020-09-22,1,1,5826000,1223460,7049460
5827,2024-01-10,1,2,5827000,1223670,7050670
5828,2023-01-07,2,1,5828000,1223880,7051880
5829,2020-12-06,2,3,5829000,1224090,7053090
5830,2023-11-02,1,2,5830000,1224300,7054300
5831,2023-01-25,1,2,5831000,1224510,7055510
5832,2022-04-07,3,1,5832000,1224720,7056720
5833,2022-11-14,1,2,5833000,1224930,7057930
5834,2022-05-10,1,1,5834000,1225140,7059140
5835,2020-10-23,1,1,5835000,1225350,7060350
5836,2020-12-12,2,3,5836000,1225560,7061560
5837,2024-09-12,3,2,5837000,1225770,7062770
5838,2022-05-16,3,2,5838000,1225980,7063980
5839,2024-12-02,1,2,5839000,1226190,7065190
5840,2024-09-18,2,1,5840000,1226400,7066400
5841,2021-01-18,1,2,5841000,1226610,7067610
5842,2022-03-16,2,2,5842000,1226820,7068820
5843,2021-02-08,2,3,5843000,1227030,7070030
5844,2022-06-24,2,2,5844000,1227240,7071240
5845,2023-07-01,2,3,5845000,1227450,7072450
5846,2022-05-06,3,3,5846000,1227660,7073660
5847,2021-01-28,2,3,5847000,1227870,7074870
5848,2024-06-28,2,2,5848000,1228080,7076080
5849,2022-05-27,1,2,5849000,1228290,7077290
5850,2022-10-04,2,3,5850000,1228500,7078500
5851,2022-06-30,2,2,5851000,1228710,7079710
5852,2023-06-11,3,2,5852000,1228920,7080920
5853,2021-05-14,3,1,5853000,1229130,7082130
5854,2024-09-15,2,2,5854000,1229340,7083340
5855,2020-10-24,1,1,5855000,1229550,7084550
5856,2022-08-10,2,1,5856000,1229760,7085760
5857,2023-06-13,2,1,5857000,1229970,7086970
5858,2024-12-19,3,3,5858000,1230180,7088180
5859,2023-05-27,1,1,5859000,1230390,7089390
5860,2021-11-11,1,3,5860000,1230600,7090600
5861,2021-02-24,2,2,5861000,1230810,7091810
5862,2024-11-05,3,2,5862000,1231020,7093020
5863,2021-07-28,3,1,5863000,1231230,7094230
5864,2023-05-29,2,2,5864000,1231440,7095440
5865,2024-12-17,2,3,5865000,1231650,7096650
5866,2020-05-28,2,1,5866000,1231860,7097860
5867,2020-01-02,2,3,5867000,1232070,7099070
5868,2023-12-20,2,2,5868000,1232280,7100280
5869,2020-12-25,1,1,5869000,1232490,7101490
5870,2020-08-29,2,3,5870000,1232700,7102700
5871,2023-06-14,1,3,5871000,1232910,7103910
5872,2022-10-02,2,2,5872000,1233120,7105120
5873,2022-05-27,3,2,5873000,1233330,7106330
5874,2024-06-10,3,1,5874000,1233540,7107540
5875,2020-03-28,2,3,5875000,1233750,7108750
5876,2020-05-01,2,3,5876000,1233960,7109960
5877,2021-07-01,2,1,5877000,1234170,7111170
5878,2024-07-06,1,3,5878000,1234380,7112380
5879,2023-05-16,3,2,5879000,1234590,7113590
5880,2021-06-10,1,3,5880000,1234800,7114800
5881,2024-05-19,2,1,5881000,1235010,7116010
5882,2021-02-01,3,3,5882000,1235220,7117220
5883,2022-08-10,3,3,5883000,1235430,7118430
5884,2020-08-06,2,2,5884000,1235640,7119640
5885,2023-12-11,3,3,5885000,1235850,7120850
5886,2020-08-07,3,1,5886000,1236060,7122060
5887,2022-03-15,1,1,5887000,1236270,7123270
5888,2024-04-22,3,3,5888000,1236480,7124480
5889,2021-10-10,3,1,5889000,1236690,7125690
5890,2021-09-02,1,2,5890000,1236900,7126900
5891,2022-12-15,2,2,5891000,1237110,7128110
5892,2021-02-11,3,1,5892000,1237320,7129320
5893,2024-09-15,2,3,5893000,1237530,7130530
5894,2023-01-16,3,3,5894000,1237740,7131740
5895,2021-03-30,3,1,5895000,1237950,7132950
5896,2020-09-23,1,1,5896000,1238160,7134160
5897,2022-02-04,3,2,5897000,1238370,7135370
5898,2022-12-13,1,1,5898000,1238580,7136580
5899,2022-11-29,1,2,5899000,1238790,7137790
5900,2024-11-17,1,2,5900000,1239000,7139000
5901,2023-11-26,3,1,5901000,1239210,7140210
5902,2020-05-06,1,3,5902000,1239420,7141420
5903,2024-07-28,2,3,5903000,1239630,7142630
5904,2023-02-06,1,2,5904000,1239840,7143840
5905,2022-12-22,3,2,5905000,1240050,7145050
5906,2020-04-28,2,3,5906000,1240260,7146260
5907,2024-06-09,3,1,5907000,1240470,7147470
5908,2023-04-29,1,3,5908000,1240680,7148680
5909,2020-02-13,3,2,5909000,1240890,7149890
5910,2022-11-04,2,3,5910000,1241100,7151100
5911,2021-10-17,2,3,5911000,1241310,7152310
5912,2020-12-22,2,3,5912000,1241520,7153520
5913,2024-07-04,3,3,5913000,1241730,7154730
5914,2023-06-25,3,3,5914000,1241940,7155940
5915,2022-03-25,3,1,5915000,1242150,7157150
5916,2020-05-11,3,1,5916000,1242360,7158360
5917,2023-10-17,3,2,5917000,1242570,7159570
5918,2021-11-24,1,3,5918000,1242780,7160780
5919,2023-02-05,3,2,5919000,1242990,7161990
5920,2020-08-24,1,1,5920000,1243200,7163200
5921,2021-07-12,1,2,5921000,1243410,7164410
5922,2020-10-26,2,3,5922000,1243620,7165620
5923,2023-05-07,3,1,5923000,1243830,7166830
5924,2021-09-15,1,2,5924000,1244040,7168040
5925,2020-10-16,2,2,5925000,1244250,7169250
5926,2021-11-26,3,2,5926000,1244460,7170460
5927,2020-10-26,2,2,5927000,1244670,7171670
5928,2021-05-16,2,3,5928000,1244880,7172880
5929,2024-06-09,1,3,5929000,1245090,7174090
5930,2021-09-15,2,3,5930000,1245300,7175300
5931,2021-07-13,2,3,5931000,1245510,7176510
5932,2021-07-04,3,1,5932000,1245720,7177720
5933,2022-02-20,2,1,5933000,1245930,7178930
5934,2023-03-12,3,2,5934000,1246140,7180140
5935,2023-09-05,3,3,5935000,1246350,7181350
5936,2020-02-24,3,1,5936000,1246560,7182560
5937,2020-10-21,3,1,5937000,1246770,7183770
5938,2022-10-06,2,2,5938000,1246980,7184980
5939,2024-05-26,2,1,5939000,1247190,7186190
5940,2020-08-11,1,3,5940000,1247400,7187400
5941,2021-10-13,2,2,5941000,1247610,7188610
5942,2021-06-04,3,2,5942000,1247820,7189820
5943,2024-05-24,1,2,5943000,1248030,7191030
5944,2022-06-05,1,3,5944000,1248240,7192240
5945,2022-06-22,1,1,5945000,1248450,7193450
5946,2023-10-17,3,2,5946000,1248660,7194660
5947,2020-12-29,2,2,5947000,1248870,7195870
5948,2022-10-27,2,1,5948000,1249080,7197080
5949,2022-08-25,3,1,5949000,1249290,7198290
5950,2020-04-17,2,3,5950000,1249500,7199500
5951,2020-12-10,1,2,5951000,1249710,7200710
5952,2022-11-12,2,1,5952000,1249920,7201920
5953,2022-01-21,2,1,5953000,1250130,7203130
5954,2023-11-24,3,1,5954000,1250340,7204340
5955,2020-02-19,1,2,5955000,1250550,7205550
5956,2022-10-31,3,1,5956000,1250760,7206760
5957,2021-02-06,1,1,5957000,1250970,7207970
5958,2024-12-11,3,1,5958000,1251180,7209180
5959,2024-12-10,2,1,5959000,1251390,7210390
5960,2021-05-12,1,2,5960000,1251600,7211600
5961,2023-01-17,3,3,5961000,1251810,7212810
5962,2022-12-07,3,2,5962000,1252020,7214020
5963,2021-02-03,2,2,5963000,1252230,7215230
5964,2022-09-26,2,3,5964000,1252440,7216440
5965,2023-09-25,2,3,5965000,1252650,7217650
5966,2023-08-19,2,1,5966000,1252860,7218860
5967,2022-12-17,1,2,5967000,1253070,7220070
5968,2023-06-19,2,3,5968000,1253280,7221280
5969,2021-08-30,2,3,5969000,1253490,7222490
5970,2023-09-24,2,3,5970000,1253700,7223700
5971,2021-06-17,3,1,5971000,1253910,7224910
5972,2021-07-27,2,1,5972000,1254120,7226120
5973,2020-02-22,2,1,5973000,1254330,7227330
5974,2020-03-18,2,3,5974000,1254540,7228540
5975,2023-07-25,1,2,5975000,1254750,7229750
5976,2020-12-04,2,3,5976000,1254960,7230960
5977,2023-08-10,1,2,5977000,1255170,7232170
5978,2022-01-07,1,2,5978000,1255380,7233380
5979,2021-05-20,1,2,5979000,1255590,7234590
5980,2020-09-17,1,2,5980000,1255800,7235800
5981,2020-10-28,2,2,5981000,1256010,7237010
5982,2020-10-18,3,1,5982000,1256220,7238220
5983,2021-11-30,3,3,5983000,1256430,7239430
5984,2024-08-29,2,3,5984000,1256640,7240640
5985,2022-02-07,1,2,5985000,1256850,7241850
5986,2020-02-24,2,3,5986000,1257060,7243060
5987,2021-11-04,2,1,5987000,1257270,7244270
5988,2021-12-23,3,1,5988000,1257480,7245480
5989,2023-02-22,2,2,5989000,1257690,7246690
5990,2024-05-08,3,2,5990000,1257900,7247900
5991,2021-04-22,2,2,5991000,1258110,7249110
5992,2020-04-12,2,2,5992000,1258320,7250320
5993,2024-06-02,2,1,5993000,1258530,7251530
5994,2023-04-25,2,1,5994000,1258740,7252740
5995,2021-09-23,2,1,5995000,1258950,7253950
5996,2020-11-23,3,2,5996000,1259160,7255160
5997,2020-03-09,2,1,5997000,1259370,7256370
5998,2024-02-22,1,3,5998000,1259580,7257580
5999,2021-08-08,3,3,5999000,1259790,7258790
6000,2021-07-11,1,2,6000000,1260000,7260000
6001,2024-07-18,2,1,6001000,1260210,7261210
6002,2023-05-31,1,2,6002000,1260420,7262420
6003,2022-05-25,1,3,6003000,1260630,7263630
6004,2022-03-11,3,1,6004000,1260840,7264840
6005,2021-06-28,2,3,6005000,1261050,7266050
6006,2024-02-20,3,3,6006000,1261260,7267260
6007,2022-06-26,1,3,6007000,1261470,7268470
6008,2022-10-15,1,3,6008000,1261680,7269680
6009,2022-01-24,2,3,6009000,1261890,7270890
6010,2021-03-13,1,1,6010000,1262100,7272100
6011,2021-10-31,3,1,6011000,1262310,7273310
6012,2020-12-09,1,3,6012000,1262520,7274520
6013,2020-06-03,2,3,6013000,1262730,7275730
6014,2023-09-06,1,1,6014000,1262940,7276940
6015,2022-06-24,1,2,6015000,1263150,7278150
6016,2021-01-14,2,1,6016000,1263360,7279360
6017,2021-11-05,1,2,6017000,1263570,7280570
6018,2023-12-09,1,3,6018000,1263780,7281780
6019,2022-01-25,1,3,6019000,1263990,7282990
6020,2021-05-07,1,2,6020000,1264200,7284200
6021,2021-04-08,3,2,6021000,1264410,7285410
6022,2020-05-28,1,3,6022000,1264620,7286620
6023,2020-03-31,3,3,6023000,1264830,7287830
6024,2022-07-26,1,1,6024000,1265040,7289040
6025,2021-04-24,2,1,6025000,1265250,7290250
6026,2023-06-02,3,3,6026000,1265460,7291460
6027,2023-09-12,3,1,6027000,1265670,7292670
6028,2022-01-30,1,1,6028000,1265880,7293880
6029,2021-06-18,3,2,6029000,1266090,7295090
6030,2023-11-28,3,2,6030000,1266300,7296300
6031,2020-04-08,3,2,6031000,1266510,7297510
6032,2020-01-27,3,1,6032000,1266720,7298720
6033,2024-05-03,1,2,6033000,1266930,7299930
6034,2020-05-25,1,2,6034000,1267140,7301140
6035,2022-12-25,2,1,6035000,1267350,7302350
6036,2024-03-08,3,1,6036000,1267560,7303560
6037,2020-01-20,3,1,6037000,1267770,7304770
6038,2022-12-13,2,3,6038000,1267980,7305980
6039,2022-11-10,2,3,6039000,1268190,7307190
6040,2021-12-23,2,1,6040000,1268400,7308400
6041,2023-12-21,3,2,6041000,1268610,7309610
6042,2022-02-01,3,1,6042000,1268820,7310820
6043,2021-05-23,2,3,6043000,1269030,7312030
6044,2021-11-27,1,1,6044000,1269240,7313240
6045,2021-07-31,2,3,6045000,1269450,7314450
6046,2023-06-29,2,3,6046000,1269660,7315660
6047,2024-10-26,2,1,6047000,1269870,7316870
6048,2024-09-13,2,2,6048000,1270080,7318080
6049,2021-03-16,2,1,6049000,1270290,7319290
6050,2022-09-05,3,1,6050000,1270500,7320500
6051,2021-02-24,2,1,6051000,1270710,7321710
6052,2024-08-29,1,2,6052000,1270920,7322920
6053,2021-05-29,1,2,6053000,1271130,7324130
6054,2023-10-25,1,3,6054000,1271340,7325340
6055,2023-01-30,3,3,6055000,1271550,7326550
6056,2020-09-12,3,2,6056000,1271760,7327760
6057,2021-07-21,2,1,6057000,1271970,7328970
6058,2022-10-09,3,3,6058000,1272180,7330180
6059,2024-01-23,2,3,6059000,1272390,7331390
6060,2024-10-28,3,2,6060000,1272600,7332600
6061,2020-02-16,3,2,6061000,1272810,7333810
6062,2021-07-14,2,1,6062000,1273020,7335020
6063,2022-04-01,2,1,6063000,1273230,7336230
6064,2020-03-27,1,1,6064000,1273440,7337440
6065,2020-04-10,2,3,6065000,1273650,7338650
6066,2023-03-07,1,3,6066000,1273860,7339860
6067,2023-11-20,1,2,6067000,1274070,7341070
6068,2021-07-03,1,1,6068000,1274280,7342280
6069,2020-11-04,3,2,6069000,1274490,7343490
6070,2021-02-21,2,2,6070000,1274700,7344700
6071,2020-10-01,2,2,6071000,1274910,7345910
6072,2023-11-17,1,3,6072000,1275120,7347120
6073,2022-11-18,2,2,6073000,1275330,7348330
6074,2022-12-29,2,2,6074000,1275540,7349540
6075,2021-06-22,1,2,6075000,1275750,7350750
6076,2020-08-25,2,1,6076000,1275960,7351960
6077,2021-09-18,2,3,6077000,1276170,7353170
6078,2020-08-23,1,3,6078000,1276380,7354380
6079,2023-01-10,3,2,6079000,1276590,7355590
6080,2022-03-10,1,2,6080000,1276800,7356800
6081,2024-03-26,3,3,6081000,1277010,7358010
6082,2023-12-07,3,3,6082000,1277220,7359220
6083,2021-04-26,1,2,6083000,1277430,7360430
6084,2020-08-03,3,1,6084000,1277640,7361640
6085,2020-10-07,1,3,6085000,1277850,7362850
6086,2024-01-08,1,1,6086000,1278060,7364060
6087,2021-06-22,1,2,6087000,1278270,7365270
6088,2020-09-02,3,3,6088000,1278480,7366480
6089,2024-12-17,1,1,6089000,1278690,7367690
6090,2023-10-01,1,2,6090000,1278900,7368900
6091,2024-01-10,1,2,6091000,1279110,7370110
6092,2020-06-13,3,3,6092000,1279320,7371320
6093,2024-12-07,3,3,6093000,1279530,7372530
6094,2021-10-11,2,1,6094000,1279740,7373740
6095,2023-06-04,2,2,6095000,1279950,7374950
6096,2022-07-29,1,2,6096000,1280160,7376160
6097,2021-03-02,1,3,6097000,1280370,7377370
6098,2021-11-30,3,3,6098000,1280580,7378580
6099,2022-06-19,1,3,6099000,1280790,7379790
6100,2021-07-10,2,2,6100000,1281000,7381000
6101,2022-04-20,2,1,6101000,1281210,7382210
6102,2021-12-03,2,1,6102000,1281420,7383420
6103,2024-10-23,2,2,6103000,1281630,7384630
6104,2023-02-23,2,1,6104000,1281840,7385840
6105,2022-05-06,2,3,6105000,1282050,7387050
6106,2023-01-24,2,1,6106000,1282260,7388260
6107,2022-11-11,1,1,6107000,1282470,7389470
6108,2023-06-08,1,2,6108000,1282680,7390680
6109,2022-08-15,1,3,6109000,1282890,7391890
6110,2020-01-22,3,1,6110000,1283100,7393100
6111,2023-02-15,2,2,6111000,1283310,7394310
6112,2024-04-17,3,2,6112000,1283520,7395520
6113,2022-02-21,1,2,6113000,1283730,7396730
6114,2022-01-23,1,2,6114000,1283940,7397940
6115,2023-09-23,3,3,6115000,1284150,7399150
6116,2022-03-16,1,1,6116000,1284360,7400360
6117,2022-02-23,3,1,6117000,1284570,7401570
6118,2021-01-23,3,1,6118000,1284780,7402780
6119,2023-11-24,1,2,6119000,1284990,7403990
6120,2022-10-25,3,1,6120000,1285200,7405200
6121,2022-05-21,1,1,6121000,1285410,7406410
6122,2024-10-29,1,3,6122000,1285620,7407620
6123,2021-12-25,1,1,6123000,1285830,7408830
6124,2020-10-19,1,1,6124000,1286040,7410040
6125,2021-02-11,3,2,6125000,1286250,7411250
6126,2021-04-14,2,3,6126000,1286460,7412460
6127,2020-01-15,3,3,6127000,1286670,7413670
6128,2023-04-17,2,3,6128000,1286880,7414880
6129,2020-12-15,1,3,6129000,1287090,7416090
6130,2020-09-10,3,3,6130000,1287300,7417300
6131,2023-10-09,2,1,6131000,1287510,7418510
6132,2020-06-29,3,1,6132000,1287720,7419720
6133,2021-09-16,1,1,6133000,1287930,7420930
6134,2022-07-16,3,3,6134000,1288140,7422140
6135,2020-03-21,1,2,6135000,1288350,7423350
6136,2021-12-19,1,2,6136000,1288560,7424560
6137,2024-11-02,3,2,6137000,1288770,7425770
6138,2020-05-26,3,1,6138000,1288980,7426980
6139,2024-10-30,2,1,6139000,1289190,7428190
6140,2022-02-22,1,1,6140000,1289400,7429400
6141,2020-08-12,1,1,6141000,1289610,7430610
6142,2021-06-15,1,3,6142000,1289820,7431820
6143,2020-04-09,1,2,6143000,1290030,7433030
6144,2024-03-30,3,1,6144000,1290240,7434240
6145,2024-08-27,3,3,6145000,1290450,7435450
6146,2020-05-20,3,3,6146000,1290660,7436660
6147,2024-11-24,2,3,6147000,1290870,7437870
6148,2022-07-12,1,1,6148000,1291080,7439080
6149,2023-06-05,3,3,6149000,1291290,7440290
6150,2024-10-06,3,2,6150000,1291500,7441500
6151,2023-10-14,3,2,6151000,1291710,7442710
6152,2020-07-18,1,3,6152000,1291920,7443920
6153,2023-05-06,2,3,6153000,1292130,7445130
6154,2024-06-03,2,2,6154000,1292340,7446340
6155,2021-09-04,1,1,6155000,1292550,7447550
6156,2022-12-12,3,1,6156000,1292760,7448760
6157,2020-03-12,2,1,6157000,1292970,7449970
6158,2020-02-08,3,1,6158000,1293180,7451180
6159,2021-09-16,3,2,6159000,1293390,7452390
6160,2020-11-20,3,2,6160000,1293600,7453600
6161,2021-09-24,1,1,6161000,1293810,7454810
6162,2020-02-07,1,2,6162000,1294020,7456020
6163,2020-08-25,3,3,6163000,1294230,7457230
6164,2020-09-23,1,3,6164000,1294440,7458440
6165,2021-01-03,2,1,6165000,1294650,7459650
6166,2020-06-02,2,1,6166000,1294860,7460860
6167,2023-07-28,1,2,6167000,1295070,7462070
6168,2020-07-27,2,1,6168000,1295280,7463280
6169,2023-03-23,3,1,6169000,1295490,7464490
6170,2024-04-04,3,1,6170000,1295700,7465700
6171,2020-05-21,1,1,6171000,1295910,7466910
6172,2023-01-25,2,3,6172000,1296120,7468120
6173,2021-04-17,3,3,6173000,1296330,7469330
6174,2023-04-02,2,3,6174000,1296540,7470540
6175,2021-11-19,1,1,6175000,1296750,7471750
6176,2024-11-23,1,3,6176000,1296960,7472960
6177,2020-12-23,1,1,6177000,1297170,7474170
6178,2023-07-25,3,3,6178000,1297380,7475380
6179,2022-05-08,1,3,6179000,1297590,7476590
6180,2022-07-17,2,1,6180000,1297800,7477800
6181,2020-04-15,2,3,6181000,1298010,7479010
6182,2023-05-09,1,2,6182000,1298220,7480220
6183,2023-03-21,1,3,6183000,1298430,7481430
6184,2024-03-26,3,2,6184000,1298640,7482640
6185,2022-12-09,1,2,6185000,1298850,7483850
6186,2022-03-15,3,1,6186000,1299060,7485060
6187,2022-04-14,3,2,6187000,1299270,7486270
6188,2023-01-13,3,1,6188000,1299480,7487480
6189,2024-06-01,3,1,6189000,1299690,7488690
6190,2022-05-08,3,1,6190000,1299900,7489900
6191,2023-08-07,3,1,6191000,1300110,7491110
6192,2022-01-23,1,3,6192000,1300320,7492320
6193,2024-03-25,1,3,6193000,1300530,7493530
6194,2024-08-26,1,2,6194000,1300740,7494740
6195,2022-10-14,3,2,6195000,1300950,7495950
6196,2024-07-18,2,1,6196000,1301160,7497160
6197,2022-11-28,1,1,6197000,1301370,7498370
6198,2021-10-04,1,1,6198000,1301580,7499580
6199,2023-12-26,1,2,6199000,1301790,7500790
6200,2022-09-09,2,1,6200000,1302000,7502000
6201,2024-11-30,2,1,6201000,1302210,7503210
6202,2023-09-27,3,1,6202000,1302420,7504420
6203,2024-11-28,3,3,6203000,1302630,7505630
6204,2024-09-17,1,2,6204000,1302840,7506840
6205,2021-10-26,1,2,6205000,1303050,7508050
6206,2022-01-01,1,3,6206000,1303260,7509260
6207,2022-05-27,3,3,6207000,1303470,7510470
6208,2023-06-12,1,2,6208000,1303680,7511680
6209,2023-08-19,3,3,6209000,1303890,7512890
6210,2021-12-14,1,1,6210000,1304100,7514100
6211,2022-12-02,3,3,6211000,1304310,7515310
6212,2024-11-05,3,2,6212000,1304520,7516520
6213,2023-09-29,3,3,6213000,1304730,7517730
6214,2021-10-18,3,3,6214000,1304940,7518940
6215,2021-06-01,2,1,6215000,1305150,7520150
6216,2023-01-06,1,3,6216000,1305360,7521360
6217,2021-05-04,3,2,6217000,1305570,7522570
6218,2020-03-05,1,3,6218000,1305780,7523780
6219,2022-12-20,3,1,6219000,1305990,7524990
6220,2020-09-20,2,2,6220000,1306200,7526200
6221,2023-04-11,2,2,6221000,1306410,7527410
6222,2023-12-17,1,1,6222000,1306620,7528620
6223,2023-01-07,1,3,6223000,1306830,7529830
6224,2023-04-29,1,3,6224000,1307040,7531040
6225,2022-03-16,1,2,6225000,1307250,7532250
6226,2020-02-18,3,2,6226000,1307460,7533460
6227,2020-08-06,3,2,6227000,1307670,7534670
6228,2024-02-19,2,1,6228000,1307880,7535880
6229,2022-09-22,3,1,6229000,1308090,7537090
6230,2020-08-11,3,2,6230000,1308300,7538300
6231,2021-07-31,1,2,6231000,1308510,7539510
6232,2020-12-11,3,3,6232000,1308720,7540720
6233,2022-12-03,1,2,6233000,1308930,7541930
6234,2022-04-12,3,1,6234000,1309140,7543140
6235,2024-10-18,3,3,6235000,1309350,7544350
6236,2020-03-21,1,3,6236000,1309560,7545560
6237,2022-09-19,2,1,6237000,1309770,7546770
6238,2024-12-28,2,1,6238000,1309980,7547980
6239,2024-01-04,2,1,6239000,1310190,7549190
6240,2024-10-21,2,3,6240000,1310400,7550400
6241,2024-04-24,3,3,6241000,1310610,7551610
6242,2021-12-08,3,3,6242000,1310820,7552820
6243,2024-12-02,3,3,6243000,1311030,7554030
6244,2024-11-04,1,1,6244000,1311240,7555240
6245,2021-04-29,3,1,6245000,1311450,7556450
6246,2023-04-28,3,1,6246000,1311660,7557660
6247,2021-07-26,1,2,6247000,1311870,7558870
6248,2024-04-29,3,3,6248000,1312080,7560080
6249,2024-10-05,2,1,6249000,1312290,7561290
6250,2020-02-03,1,3,6250000,1312500,7562500
6251,2023-06-21,3,1,6251000,1312710,7563710
6252,2021-12-14,2,2,6252000,1312920,7564920
6253,2022-08-10,2,1,6253000,1313130,7566130
6254,2023-07-21,1,2,6254000,1313340,7567340
6255,2020-09-12,3,3,6255000,1313550,7568550
6256,2024-08-14,1,1,6256000,1313760,7569760
6257,2024-01-19,2,2,6257000,1313970,7570970
6258,2021-07-14,2,3,6258000,1314180,7572180
6259,2024-11-02,2,3,6259000,1314390,7573390
6260,2021-11-12,2,3,6260000,1314600,7574600
6261,2020-06-01,1,3,6261000,1314810,7575810
6262,2023-08-10,3,3,6262000,1315020,7577020
6263,2021-05-11,1,2,6263000,1315230,7578230
6264,2022-07-04,1,3,6264000,1315440,7579440
6265,2024-02-15,2,1,6265000,1315650,7580650
6266,2021-06-07,3,3,6266000,1315860,7581860
6267,2021-02-25,2,3,6267000,1316070,7583070
6268,2024-11-28,1,2,6268000,1316280,7584280
6269,2023-03-21,2,1,6269000,1316490,7585490
6270,2023-03-09,1,3,6270000,1316700,7586700
6271,2021-05-18,3,1,6271000,1316910,7587910
6272,2023-04-26,3,2,6272000,1317120,7589120
6273,2021-06-14,3,2,6273000,1317330,7590330
6274,2024-06-16,1,2,6274000,1317540,7591540
6275,2021-07-22,2,3,6275000,1317750,7592750
6276,2021-03-12,2,3,6276000,1317960,7593960
6277,2022-06-13,3,1,6277000,1318170,7595170
6278,2023-02-27,1,2,6278000,1318380,7596380
6279,2022-09-06,3,1,6279000,1318590,7597590
6280,2022-03-16,3,1,6280000,1318800,7598800
6281,2021-04-06,1,3,6281000,1319010,7600010
6282,2022-09-25,3,1,6282000,1319220,7601220
6283,2021-11-10,1,1,6283000,1319430,7602430
6284,2021-07-24,3,1,6284000,1319640,7603640
6285,2024-12-01,2,1,6285000,1319850,7604850
6286,2021-03-28,3,2,6286000,1320060,7606060
6287,2021-02-16,2,1,6287000,1320270,7607270
6288,2021-11-09,2,2,6288000,1320480,7608480
6289,2022-04-06,1,3,6289000,1320690,7609690
6290,2020-05-02,3,2,6290000,1320900,7610900
6291,2020-04-11,2,2,6291000,1321110,7612110
6292,2022-07-09,2,1,6292000,1321320,7613320
6293,2020-05-21,2,3,6293000,1321530,7614530
6294,2024-01-06,3,2,6294000,1321740,7615740
6295,2022-07-22,1,1,6295000,1321950,7616950
6296,2022-06-23,1,3,6296000,1322160,7618160
6297,2022-03-11,1,3,6297000,1322370,7619370
6298,2021-05-25,1,3,6298000,1322580,7620580
6299,2023-07-26,3,1,6299000,1322790,7621790
6300,2020-12-24,2,2,6300000,1323000,7623000
6301,2023-06-25,3,2,6301000,1323210,7624210
6302,2020-09-29,2,3,6302000,1323420,7625420
6303,2020-04-27,3,2,6303000,1323630,7626630
6304,2024-06-05,2,2,6304000,1323840,7627840
6305,2021-07-09,1,2,6305000,1324050,7629050
6306,2023-11-11,1,3,6306000,1324260,7630260
6307,2021-11-02,3,2,6307000,1324470,7631470
6308,2024-12-15,1,3,6308000,1324680,7632680
6309,2023-01-20,2,3,6309000,1324890,7633890
6310,2023-02-10,3,1,6310000,1325100,7635100
6311,2021-10-12,2,2,6311000,1325310,7636310
6312,2021-03-15,2,1,6312000,1325520,7637520
6313,2020-09-08,1,3,6313000,1325730,7638730
6314,2021-06-22,3,1,6314000,1325940,7639940
6315,2022-11-06,2,1,6315000,1326150,7641150
6316,2023-09-06,1,3,6316000,1326360,7642360
6317,2022-04-24,3,2,6317000,1326570,7643570
6318,2022-06-26,1,1,6318000,1326780,7644780
6319,2023-06-14,2,3,6319000,1326990,7645990
6320,2023-11-21,1,1,6320000,1327200,7647200
6321,2023-07-03,2,2,6321000,1327410,7648410
6322,2022-10-02,1,3,6322000,1327620,7649620
6323,2022-12-29,3,3,6323000,1327830,7650830
6324,2022-04-16,2,2,6324000,1328040,7652040
6325,2024-01-05,1,1,6325000,1328250,7653250
6326,2020-10-11,3,3,6326000,1328460,7654460
6327,2020-03-15,3,2,6327000,1328670,7655670
6328,2022-02-05,2,3,6328000,1328880,7656880
6329,2021-02-19,1,2,6329000,1329090,7658090
6330,2023-10-23,3,3,6330000,1329300,7659300
6331,2022-02-04,2,2,6331000,1329510,7660510
6332,2020-05-06,1,3,6332000,1329720,7661720
6333,2024-09-21,1,3,6333000,1329930,7662930
6334,2024-08-10,1,1,6334000,1330140,7664140
6335,2020-05-11,3,3,6335000,1330350,7665350
6336,2022-02-12,3,3,6336000,1330560,7666560
6337,2024-12-15,3,3,6337000,1330770,7667770
6338,2024-09-08,3,1,6338000,1330980,7668980
6339,2023-04-28,1,3,6339000,1331190,7670190
6340,2024-05-15,2,1,6340000,1331400,7671400
6341,2024-08-21,3,1,6341000,1331610,7672610
6342,2021-08-05,2,1,6342000,1331820,7673820
6343,2024-10-04,1,1,6343000,1332030,7675030
6344,2024-08-03,3,3,6344000,1332240,7676240
6345,2023-11-16,1,2,6345000,1332450,7677450
6346,2021-06-10,3,2,6346000,1332660,7678660
6347,2023-03-01,2,1,6347000,1332870,7679870
6348,2023-10-11,3,1,6348000,1333080,7681080
6349,2024-02-22,2,3,6349000,1333290,7682290
6350,2022-04-18,2,3,6350000,1333500,7683500
6351,2020-01-29,2,1,6351000,1333710,7684710
6352,2022-10-01,2,1,6352000,1333920,7685920
6353,2022-02-07,3,3,6353000,1334130,7687130
6354,2021-02-19,3,1,6354000,1334340,7688340
6355,2022-01-18,1,1,6355000,1334550,7689550
6356,2023-08-15,3,1,6356000,1334760,7690760
6357,2024-12-27,2,1,6357000,1334970,7691970
6358,2022-02-21,3,3,6358000,1335180,7693180
6359,2020-04-25,1,3,6359000,1335390,7694390
6360,2022-11-14,2,2,6360000,1335600,7695600
6361,2023-01-21,3,3,6361000,1335810,7696810
6362,2024-07-22,2,2,6362000,1336020,7698020
6363,2023-10-16,1,2,6363000,1336230,7699230
6364,2020-04-09,1,2,6364000,1336440,7700440
6365,2023-02-27,1,2,6365000,1336650,7701650
6366,2021-01-19,3,3,6366000,1336860,7702860
6367,2021-01-19,2,3,6367000,1337070,7704070
6368,2024-12-20,1,1,6368000,1337280,7705280
6369,2022-05-29,3,1,6369000,1337490,7706490
6370,2023-05-31,2,2,6370000,1337700,7707700
6371,2023-09-12,1,3,6371000,1337910,7708910
6372,2024-03-24,3,3,6372000,1338120,7710120
6373,2024-12-11,3,3,6373000,1338330,7711330
6374,2020-03-07,1,3,6374000,1338540,7712540
6375,2024-04-12,3,3,6375000,1338750,7713750
6376,2020-10-10,2,2,6376000,1338960,7714960
6377,2022-05-08,1,1,6377000,1339170,7716170
6378,2022-07-23,3,1,6378000,1339380,7717380
6379,2024-03-25,3,2,6379000,1339590,7718590
6380,2021-08-26,3,2,6380000,1339800,7719800
6381,2021-12-28,2,2,6381000,1340010,7721010
6382,2024-04-26,2,3,6382000,1340220,7722220
6383,2024-11-18,1,1,6383000,1340430,7723430
6384,2021-07-05,2,1,6384000,1340640,7724640
6385,2024-06-27,2,2,6385000,1340850,7725850
6386,2024-05-12,2,1,6386000,1341060,7727060
6387,2024-10-09,2,1,6387000,1341270,7728270
6388,2021-09-29,3,2,6388000,1341480,7729480
6389,2020-06-09,2,1,6389000,1341690,7730690
6390,2024-05-22,2,3,6390000,1341900,7731900
6391,2020-01-28,3,2,6391000,1342110,7733110
6392,2023-09-11,3,1,6392000,1342320,7734320
6393,2021-05-28,3,3,6393000,1342530,7735530
6394,2022-09-07,1,1,6394000,1342740,7736740
6395,2020-08-22,2,3,6395000,1342950,7737950
6396,2020-04-01,1,2,6396000,1343160,7739160
6397,2021-01-02,2,1,6397000,1343370,7740370
6398,2020-03-09,3,2,6398000,1343580,7741580
6399,2024-11-13,2,3,6399000,1343790,7742790
6400,2022-11-27,3,3,6400000,1344000,7744000
6401,2023-11-07,1,1,6401000,1344210,7745210
6402,2022-01-16,2,2,6402000,1344420,7746420
6403,2021-08-02,3,3,6403000,1344630,7747630
6404,2021-03-22,2,2,6404000,1344840,7748840
6405,2020-02-01,1,2,6405000,1345050,7750050
6406,2020-07-29,3,3,6406000,1345260,7751260
6407,2023-08-14,3,1,6407000,1345470,7752470
6408,2021-01-25,3,2,6408000,1345680,7753680
6409,2024-05-30,3,3,6409000,1345890,7754890
6410,2022-08-21,2,2,6410000,1346100,7756100
6411,2020-04-07,3,1,6411000,1346310,7757310
6412,2022-09-05,3,2,6412000,1346520,7758520
6413,2021-09-01,3,1,6413000,1346730,7759730
6414,2024-12-27,1,1,6414000,1346940,7760940
6415,2022-02-22,3,1,6415000,1347150,7762150
6416,2024-03-24,3,1,6416000,1347360,7763360
6417,2024-11-30,3,2,6417000,1347570,7764570
6418,2023-12-15,1,2,6418000,1347780,7765780
6419,2024-06-02,2,1,6419000,1347990,7766990
6420,2024-07-12,2,1,6420000,1348200,7768200
6421,2021-07-27,3,2,6421000,1348410,7769410
6422,2020-11-26,3,3,6422000,1348620,7770620
6423,2022-07-04,3,1,6423000,1348830,7771830
6424,2021-12-12,3,2,6424000,1349040,7773040
6425,2023-01-03,1,1,6425000,1349250,7774250
6426,2021-03-29,3,2,6426000,1349460,7775460
6427,2023-07-04,3,2,6427000,1349670,7776670
6428,2023-05-29,3,3,6428000,1349880,7777880
6429,2022-12-20,2,3,6429000,1350090,7779090
6430,2022-02-23,1,2,6430000,1350300,7780300
6431,2021-11-03,3,1,6431000,1350510,7781510
6432,2021-04-12,1,3,6432000,1350720,7782720
6433,2023-01-15,2,1,6433000,1350930,7783930
6434,2021-09-05,1,1,6434000,1351140,7785140
6435,2024-11-16,1,3,6435000,1351350,7786350
6436,2023-12-10,1,1,6436000,1351560,7787560
6437,2020-01-27,3,2,6437000,1351770,7788770
6438,2020-01-29,2,1,6438000,1351980,7789980
6439,2020-09-06,1,3,6439000,1352190,7791190
6440,2020-11-15,3,1,6440000,1352400,7792400
6441,2024-02-28,1,1,6441000,1352610,7793610
6442,2021-04-20,3,1,6442000,1352820,7794820
6443,2022-09-10,2,1,6443000,1353030,7796030
6444,2023-07-01,3,3,6444000,1353240,7797240
6445,2021-11-24,2,1,6445000,1353450,7798450
6446,2022-09-29,1,2,6446000,1353660,7799660
6447,2024-06-10,2,3,6447000,1353870,7800870
6448,2023-11-03,2,1,6448000,1354080,7802080
6449,2022-07-05,3,2,6449000,1354290,7803290
6450,2023-11-29,1,3,6450000,1354500,7804500
6451,2020-09-19,1,2,6451000,1354710,7805710
6452,2021-02-20,3,1,6452000,1354920,7806920
6453,2022-06-14,1,1,6453000,1355130,7808130
6454,2022-05-31,1,2,6454000,1355340,7809340
6455,2022-08-01,1,2,6455000,1355550,7810550
6456,2024-06-22,3,3,6456000,1355760,7811760
6457,2022-09-19,3,3,6457000,1355970,7812970
6458,2023-07-04,1,3,6458000,1356180,7814180
6459,2021-06-20,2,2,6459000,1356390,7815390
6460,2023-08-28,2,3,6460000,1356600,7816600
6461,2021-01-18,1,3,6461000,1356810,7817810
6462,2021-12-18,3,2,6462000,1357020,7819020
6463,2020-01-28,3,2,6463000,1357230,7820230
6464,2022-01-02,3,1,6464000,1357440,7821440
6465,2023-05-19,1,2,6465000,1357650,7822650
6466,2022-03-12,3,1,6466000,1357860,7823860
6467,2024-02-14,2,3,6467000,1358070,7825070
6468,2020-03-18,3,3,6468000,1358280,7826280
6469,2022-11-25,2,3,6469000,1358490,7827490
6470,2022-08-20,2,3,6470000,1358700,7828700
6471,2023-07-24,1,2,6471000,1358910,7829910
6472,2020-06-25,3,2,6472000,1359120,7831120
6473,2023-04-24,2,3,6473000,1359330,7832330
6474,2020-11-16,1,3,6474000,1359540,7833540
6475,2021-07-23,1,1,6475000,1359750,7834750
6476,2023-02-02,3,2,6476000,1359960,7835960
6477,2020-03-21,1,3,6477000,1360170,7837170
6478,2024-09-18,3,1,6478000,1360380,7838380
6479,2020-05-22,2,1,6479000,1360590,7839590
6480,2024-03-12,1,2,6480000,1360800,7840800
6481,2022-12-10,3,2,6481000,1361010,7842010
6482,2020-06-18,1,1,6482000,1361220,7843220
6483,2021-05-26,1,2,6483000,1361430,7844430
6484,2024-10-11,1,1,6484000,1361640,7845640
6485,2020-07-19,3,2,6485000,1361850,7846850
6486,2022-08-15,2,2,6486000,1362060,7848060
6487,2020-06-29,2,2,6487000,1362270,7849270
6488,2023-12-04,1,3,6488000,1362480,7850480
6489,2021-05-20,1,2,6489000,1362690,7851690
6490,2020-12-08,2,2,6490000,1362900,7852900
6491,2024-04-25,1,3,6491000,1363110,7854110
6492,2022-11-10,1,3,6492000,1363320,7855320
6493,2020-11-07,3,2,6493000,1363530,7856530
6494,2020-12-25,3,2,6494000,1363740,7857740
6495,2023-10-26,2,1,6495000,1363950,7858950
6496,2020-12-03,1,1,6496000,1364160,7860160
6497,2021-01-19,2,1,6497000,1364370,7861370
6498,2024-04-11,1,1,6498000,1364580,7862580
6499,2020-05-21,3,1,6499000,1364790,7863790
6500,2023-08-15,1,2,6500000,1365000,7865000
6501,2022-12-16,1,1,6501000,1365210,7866210
6502,2023-10-13,2,2,6502000,1365420,7867420
6503,2024-07-27,1,2,6503000,1365630,7868630
6504,2023-02-07,2,1,6504000,1365840,7869840
6505,2023-08-18,1,1,6505000,1366050,7871050
6506,2021-12-12,2,1,6506000,1366260,7872260
6507,2021-06-05,1,3,6507000,1366470,7873470
6508,2020-02-15,1,1,6508000,1366680,7874680
6509,2020-01-14,1,3,6509000,1366890,7875890
6510,2021-03-01,2,1,6510000,1367100,7877100
6511,2023-05-31,2,2,6511000,1367310,7878310
6512,2021-09-25,2,1,6512000,1367520,7879520
6513,2024-11-17,1,3,6513000,1367730,7880730
6514,2024-11-23,3,2,6514000,1367940,7881940
6515,2024-05-23,1,1,6515000,1368150,7883150
6516,2022-04-28,1,2,6516000,1368360,7884360
6517,2022-02-04,2,2,6517000,1368570,7885570
6518,2022-10-25,2,1,6518000,1368780,7886780
6519,2020-09-14,1,1,6519000,1368990,7887990
6520,2024-08-26,3,1,6520000,1369200,7889200
6521,2023-12-17,1,1,6521000,1369410,7890410
6522,2023-01-14,2,2,6522000,1369620,7891620
6523,2023-04-26,2,1,6523000,1369830,7892830
6524,2024-03-11,2,3,6524000,1370040,7894040
6525,2020-11-17,3,2,6525000,1370250,7895250
6526,2021-06-25,3,1,6526000,1370460,7896460
6527,2021-09-15,3,1,6527000,1370670,7897670
6528,2020-06-15,2,2,6528000,1370880,7898880
6529,2024-10-12,2,1,6529000,1371090,7900090
6530,2020-03-17,3,2,6530000,1371300,7901300
6531,2023-07-15,1,2,6531000,1371510,7902510
6532,2023-04-11,3,2,6532000,1371720,7903720
6533,2024-06-23,1,1,6533000,1371930,7904930
6534,2023-12-06,3,3,6534000,1372140,7906140
6535,2023-01-05,2,3,6535000,1372350,7907350
6536,2023-02-17,3,3,6536000,1372560,7908560
6537,2021-05-07,2,3,6537000,1372770,7909770
6538,2021-06-23,2,2,6538000,1372980,7910980
6539,2024-10-04,3,3,6539000,1373190,7912190
6540,2023-08-29,2,1,6540000,1373400,7913400
6541,2021-11-16,1,3,6541000,1373610,7914610
6542,2021-10-06,3,3,6542000,1373820,7915820
6543,2021-05-30,2,3,6543000,1374030,7917030
6544,2020-10-23,2,1,6544000,1374240,7918240
6545,2023-12-16,1,1,6545000,1374450,7919450
6546,2023-12-04,1,2,6546000,1374660,7920660
6547,2024-02-12,2,2,6547000,1374870,7921870
6548,2023-11-23,2,2,6548000,1375080,7923080
6549,2020-11-17,2,2,6549000,1375290,7924290
6550,2022-05-17,1,3,6550000,1375500,7925500
6551,2020-05-04,3,3,6551000,1375710,7926710
6552,2021-11-09,3,3,6552000,1375920,7927920
6553,2020-08-01,3,2,6553000,1376130,7929130
6554,2022-04-27,3,1,6554000,1376340,7930340
6555,2021-03-07,2,3,6555000,1376550,7931550
6556,2023-05-14,2,3,6556000,1376760,7932760
6557,2021-01-29,1,1,6557000,1376970,7933970
6558,2024-08-28,2,3,6558000,1377180,7935180
6559,2021-07-15,1,3,6559000,1377390,7936390
6560,2022-07-02,3,3,6560000,1377600,7937600
6561,2024-08-21,3,3,6561000,1377810,7938810
6562,2022-09-10,2,1,6562000,1378020,7940020
6563,2024-11-10,3,2,6563000,1378230,7941230
6564,2021-10-24,3,1,6564000,1378440,7942440
6565,2022-04-01,3,3,6565000,1378650,7943650
6566,2022-01-21,3,1,6566000,1378860,7944860
6567,2023-09-12,3,1,6567000,1379070,7946070
6568,2020-02-19,1,2,6568000,1379280,7947280
6569,2021-03-05,1,2,6569000,1379490,7948490
6570,2024-04-07,1,1,6570000,1379700,7949700
6571,2024-01-14,3,2,6571000,1379910,7950910
6572,2024-12-08,3,1,6572000,1380120,7952120
6573,2022-10-20,1,2,6573000,1380330,7953330
6574,2022-10-07,1,2,6574000,1380540,7954540
6575,2024-08-16,3,1,6575000,1380750,7955750
6576,2023-07-10,3,1,6576000,1380960,7956960
6577,2022-01-20,2,2,6577000,1381170,7958170
6578,2021-07-31,3,1,6578000,1381380,7959380
6579,2020-12-07,1,2,6579000,1381590,7960590
6580,2024-05-21,2,2,6580000,1381800,7961800
6581,2020-07-07,1,3,6581000,1382010,7963010
6582,2021-04-25,2,3,6582000,1382220,7964220
6583,2022-05-30,3,2,6583000,1382430,7965430
6584,2022-03-29,2,2,6584000,1382640,7966640
6585,2024-03-07,1,2,6585000,1382850,7967850
6586,2023-11-02,3,3,6586000,1383060,7969060
6587,2022-05-25,3,2,6587000,1383270,7970270
6588,2021-12-30,3,1,6588000,1383480,7971480
6589,2020-03-17,1,2,6589000,1383690,7972690
6590,2024-08-06,1,3,6590000,1383900,7973900
6591,2024-02-11,3,1,6591000,1384110,7975110
6592,2022-02-07,3,3,6592000,1384320,7976320
6593,2022-11-29,2,3,6593000,1384530,7977530
6594,2024-01-21,2,2,6594000,1384740,7978740
6595,2020-03-26,3,2,6595000,1384950,7979950
6596,2020-05-27,2,1,6596000,1385160,7981160
6597,2021-04-25,2,3,6597000,1385370,7982370
6598,2020-04-11,1,1,6598000,1385580,7983580
6599,2020-10-17,1,3,6599000,1385790,7984790
6600,2024-06-30,2,3,6600000,1386000,7986000
6601,2023-09-29,3,2,6601000,1386210,7987210
6602,2020-10-22,1,2,6602000,1386420,7988420
6603,2020-12-07,2,2,6603000,1386630,7989630
6604,2022-08-22,2,1,6604000,1386840,7990840
6605,2020-01-20,2,1,6605000,1387050,7992050
6606,2020-04-28,1,1,6606000,1387260,7993260
6607,2021-08-05,3,2,6607000,1387470,7994470
6608,2024-05-03,2,1,6608000,1387680,7995680
6609,2021-12-18,1,1,6609000,1387890,7996890
6610,2023-07-31,1,2,6610000,1388100,7998100
6611,2023-03-17,1,1,6611000,1388310,7999310
6612,2020-06-22,1,1,6612000,1388520,8000520
6613,2020-12-19,3,2,6613000,1388730,8001730
6614,2023-08-10,1,3,6614000,1388940,8002940
6615,2021-12-09,1,1,6615000,1389150,8004150
6616,2023-10-22,1,3,6616000,1389360,8005360
6617,2020-03-17,1,3,6617000,1389570,8006570
6618,2024-02-04,1,1,6618000,1389780,8007780
6619,2022-01-22,1,2,6619000,1389990,8008990
6620,2024-03-06,1,3,6620000,1390200,8010200
6621,2022-12-14,2,2,6621000,1390410,8011410
6622,2024-06-11,2,1,6622000,1390620,8012620
6623,2022-08-16,3,3,6623000,1390830,8013830
6624,2021-12-02,1,1,6624000,1391040,8015040
6625,2022-06-18,2,1,6625000,1391250,8016250
6626,2022-04-01,3,2,6626000,1391460,8017460
6627,2020-05-09,1,3,6627000,1391670,8018670
6628,2024-09-24,1,1,6628000,1391880,8019880
6629,2022-09-09,2,1,6629000,1392090,8021090
6630,2024-09-08,3,1,6630000,1392300,8022300
6631,2021-10-11,3,3,6631000,1392510,8023510
6632,2021-04-27,3,1,6632000,1392720,8024720
6633,2022-05-08,1,1,6633000,1392930,8025930
6634,2020-10-09,2,2,6634000,1393140,8027140
6635,2021-07-16,3,3,6635000,1393350,8028350
6636,2020-08-26,1,2,6636000,1393560,8029560
6637,2023-03-20,1,2,6637000,1393770,8030770
6638,2023-06-16,3,2,6638000,1393980,8031980
6639,2020-02-15,1,3,6639000,1394190,8033190
6640,2024-05-16,3,3,6640000,1394400,8034400
6641,2020-04-01,1,2,6641000,1394610,8035610
6642,2022-05-12,2,2,6642000,1394820,8036820
6643,2020-01-09,3,3,6643000,1395030,8038030
6644,2021-01-20,3,2,6644000,1395240,8039240
6645,2021-06-26,2,2,6645000,1395450,8040450
6646,2021-04-01,1,1,6646000,1395660,8041660
6647,2023-09-02,2,2,6647000,1395870,8042870
6648,2024-04-19,2,3,6648000,1396080,8044080
6649,2022-03-17,3,1,6649000,1396290,8045290
6650,2021-04-18,3,1,6650000,1396500,8046500
6651,2024-11-05,1,1,6651000,1396710,8047710
6652,2020-11-28,3,3,6652000,1396920,8048920
6653,2022-04-23,2,3,6653000,1397130,8050130
6654,2024-08-11,2,2,6654000,1397340,8051340
6655,2021-01-06,3,2,6655000,1397550,8052550
6656,2022-08-06,1,2,6656000,1397760,8053760
6657,2024-03-14,2,2,6657000,1397970,8054970
6658,2021-09-28,2,2,6658000,1398180,8056180
6659,2022-05-11,1,1,6659000,1398390,8057390
6660,2020-08-08,1,2,6660000,1398600,8058600
6661,2021-12-28,3,1,6661000,1398810,8059810
6662,2023-09-24,3,3,6662000,1399020,8061020
6663,2020-07-09,3,3,6663000,1399230,8062230
6664,2022-02-14,3,2,6664000,1399440,8063440
6665,2023-04-10,3,1,6665000,1399650,8064650
6666,2020-01-09,2,2,6666000,1399860,8065860
6667,2022-01-21,1,1,6667000,1400070,8067070
6668,2020-04-14,1,3,6668000,1400280,8068280
6669,2022-01-25,1,1,6669000,1400490,8069490
6670,2020-11-04,2,2,6670000,1400700,8070700
6671,2022-01-20,2,3,6671000,1400910,8071910
6672,2023-05-29,1,1,6672000,1401120,8073120
6673,2024-08-25,3,3,6673000,1401330,8074330
6674,2024-11-25,3,3,6674000,1401540,8075540
6675,2024-08-28,3,3,6675000,1401750,8076750
6676,2020-06-24,2,1,6676000,1401960,8077960
6677,2023-07-31,2,3,6677000,1402170,8079170
6678,2024-10-21,3,2,6678000,1402380,8080380
6679,2020-05-18,1,2,6679000,1402590,8081590
6680,2024-03-13,2,2,6680000,1402800,8082800
6681,2022-04-03,1,2,6681000,1403010,8084010
6682,2023-02-20,1,1,6682000,1403220,8085220
6683,2023-11-30,3,1,6683000,1403430,8086430
6684,2022-06-28,3,2,6684000,1403640,8087640
6685,2023-12-24,1,1,6685000,1403850,8088850
6686,2020-09-19,2,2,6686000,1404060,8090060
6687,2023-01-13,3,3,6687000,1404270,8091270
6688,2023-12-14,2,2,6688000,1404480,8092480
6689,2020-12-10,3,1,6689000,1404690,8093690
6690,2022-05-02,1,2,6690000,1404900,8094900
6691,2022-01-24,2,2,6691000,1405110,8096110
6692,2024-06-22,3,2,6692000,1405320,8097320
6693,2020-02-04,2,3,6693000,1405530,8098530
6694,2020-01-13,3,3,6694000,1405740,8099740
6695,2022-05-25,3,3,6695000,1405950,8100950
6696,2020-12-09,3,3,6696000,1406160,8102160
6697,2021-12-22,2,2,6697000,1406370,8103370
6698,2023-07-31,2,1,6698000,1406580,8104580
6699,2021-05-09,3,2,6699000,1406790,8105790
6700,2023-08-22,2,1,6700000,1407000,8107000
6701,2022-11-20,3,1,6701000,1407210,8108210
6702,2021-09-25,2,3,6702000,1407420,8109420
6703,2021-07-26,2,2,6703000,1407630,8110630
6704,2024-06-01,3,1,6704000,1407840,8111840
6705,2021-07-26,3,3,6705000,1408050,8113050
6706,2024-08-15,1,1,6706000,1408260,8114260
6707,2021-12-08,2,2,6707000,1408470,8115470
6708,2023-02-02,1,3,6708000,1408680,8116680
6709,2022-04-09,3,2,6709000,1408890,8117890
6710,2022-05-25,1,2,6710000,1409100,8119100
6711,2023-01-14,1,1,6711000,1409310,8120310
6712,2023-08-23,3,3,6712000,1409520,8121520
6713,2022-11-02,1,1,6713000,1409730,8122730
6714,2023-10-09,2,2,6714000,1409940,8123940
6715,2024-01-11,1,3,6715000,1410150,8125150
6716,2023-10-22,1,2,6716000,1410360,8126360
6717,2021-05-27,3,3,6717000,1410570,8127570
6718,2021-05-08,1,2,6718000,1410780,8128780
6719,2023-06-25,2,2,6719000,1410990,8129990
6720,2022-09-09,3,2,6720000,1411200,8131200
6721,2022-06-10,1,3,6721000,1411410,8132410
6722,2022-02-09,3,2,6722000,1411620,8133620
6723,2020-10-18,1,3,6723000,1411830,8134830
6724,2024-11-06,3,2,6724000,1412040,8136040
6725,2020-05-01,2,1,6725000,1412250,8137250
6726,2024-09-21,1,3,6726000,1412460,8138460
6727,2020-06-26,3,3,6727000,1412670,8139670
6728,2022-02-04,3,3,6728000,1412880,8140880
6729,2022-04-06,3,3,6729000,1413090,8142090
6730,2021-02-02,3,3,6730000,1413300,8143300
6731,2021-04-26,1,2,6731000,1413510,8144510
6732,2024-02-14,3,1,6732000,1413720,8145720
6733,2021-01-13,2,3,6733000,1413930,8146930
6734,2023-01-17,1,1,6734000,1414140,8148140
6735,2021-02-16,3,1,6735000,1414350,8149350
6736,2020-12-24,3,2,6736000,1414560,8150560
6737,2020-08-10,2,2,6737000,1414770,8151770
6738,2024-03-04,2,2,6738000,1414980,8152980
6739,2020-07-19,3,2,6739000,1415190,8154190
6740,2022-06-01,1,2,6740000,1415400,8155400
6741,2020-12-06,2,2,6741000,1415610,8156610
6742,2022-05-10,1,1,6742000,1415820,8157820
6743,2023-12-23,3,1,6743000,1416030,8159030
6744,2024-05-24,3,3,6744000,1416240,8160240
6745,2022-04-01,1,2,6745000,1416450,8161450
6746,2022-09-12,3,1,6746000,1416660,8162660
6747,2023-06-03,3,3,6747000,1416870,8163870
6748,2021-09-09,1,3,6748000,1417080,8165080
6749,2023-12-31,2,3,6749000,1417290,8166290
6750,2021-08-05,1,1,6750000,1417500,8167500
6751,2023-03-15,2,3,6751000,1417710,8168710
6752,2022-11-03,1,2,6752000,1417920,8169920
6753,2021-06-19,3,1,6753000,1418130,8171130
6754,2021-02-19,2,1,6754000,1418340,8172340
6755,2021-05-22,2,1,6755000,1418550,8173550
6756,2020-08-20,1,3,6756000,1418760,8174760
6757,2022-04-19,3,3,6757000,1418970,8175970
6758,2022-11-20,3,1,6758000,1419180,8177180
6759,2021-04-07,1,3,6759000,1419390,8178390
6760,2023-12-27,2,2,6760000,1419600,8179600
6761,2024-03-13,3,1,6761000,1419810,8180810
6762,2023-11-12,1,2,6762000,1420020,8182020
6763,2024-04-03,2,1,6763000,1420230,8183230
6764,2024-01-16,2,3,6764000,1420440,8184440
6765,2021-01-23,3,3,6765000,1420650,8185650
6766,2024-05-01,1,1,6766000,1420860,8186860
6767,2021-08-09,3,1,6767000,1421070,8188070
6768,2020-08-15,1,2,6768000,1421280,8189280
6769,2023-01-03,3,3,6769000,1421490,8190490
6770,2023-03-28,2,2,6770000,1421700,8191700
6771,2024-07-22,2,1,6771000,1421910,8192910
6772,2021-03-13,2,2,6772000,1422120,8194120
6773,2022-12-29,1,2,6773000,1422330,8195330
6774,2021-06-05,3,1,6774000,1422540,8196540
6775,2022-04-30,2,2,6775000,1422750,8197750
6776,2023-05-31,2,2,6776000,1422960,8198960
6777,2020-12-02,1,3,6777000,1423170,8200170
6778,2024-04-19,3,3,6778000,1423380,8201380
6779,2024-06-13,3,1,6779000,1423590,8202590
6780,2020-08-07,1,2,6780000,1423800,8203800
6781,2021-03-15,3,1,6781000,1424010,8205010
6782,2020-09-26,2,1,6782000,1424220,8206220
6783,2022-12-19,3,1,6783000,1424430,8207430
6784,2024-05-09,1,3,6784000,1424640,8208640
6785,2022-06-11,3,2,6785000,1424850,8209850
6786,2024-08-17,1,1,6786000,1425060,8211060
6787,2020-07-01,3,3,6787000,1425270,8212270
6788,2023-04-17,2,2,6788000,1425480,8213480
6789,2020-07-25,1,1,6789000,1425690,8214690
6790,2021-07-20,1,3,6790000,1425900,8215900
6791,2020-10-19,3,1,6791000,1426110,8217110
6792,2024-02-02,2,3,6792000,1426320,8218320
6793,2024-09-22,1,1,6793000,1426530,8219530
6794,2024-01-03,2,1,6794000,1426740,8220740
6795,2023-07-25,1,2,6795000,1426950,8221950
6796,2023-04-17,1,3,6796000,1427160,8223160
6797,2020-08-22,3,2,6797000,1427370,8224370
6798,2024-02-05,1,1,6798000,1427580,8225580
6799,2023-12-08,2,3,6799000,1427790,8226790
6800,2024-03-03,3,1,6800000,1428000,8228000
6801,2022-08-05,1,1,6801000,1428210,8229210
6802,2024-03-03,1,1,6802000,1428420,8230420
6803,2022-12-23,1,1,6803000,1428630,8231630
6804,2024-11-02,1,1,6804000,1428840,8232840
6805,2024-02-02,1,2,6805000,1429050,8234050
6806,2021-05-05,1,3,6806000,1429260,8235260
6807,2024-05-29,3,1,6807000,1429470,8236470
6808,2020-05-02,1,1,6808000,1429680,8237680
6809,2021-02-09,2,1,6809000,1429890,8238890
6810,2024-01-17,3,3,6810000,1430100,8240100
6811,2021-09-09,3,1,6811000,1430310,8241310
6812,2024-08-01,3,3,6812000,1430520,8242520
6813,2024-07-20,3,3,6813000,1430730,8243730
6814,2021-08-28,3,2,6814000,1430940,8244940
6815,2021-08-31,3,2,6815000,1431150,8246150
6816,2023-08-13,3,1,6816000,1431360,8247360
6817,2024-11-05,1,2,6817000,1431570,8248570
6818,2024-10-01,2,2,6818000,1431780,8249780
6819,2022-11-19,2,1,6819000,1431990,8250990
6820,2023-11-09,1,2,6820000,1432200,8252200
6821,2024-09-09,1,2,6821000,1432410,8253410
6822,2022-07-11,2,2,6822000,1432620,8254620
6823,2022-05-18,3,2,6823000,1432830,8255830
6824,2020-07-06,2,2,6824000,1433040,8257040
6825,2024-08-10,1,1,6825000,1433250,8258250
6826,2020-04-08,3,3,6826000,1433460,8259460
6827,2020-12-25,1,1,6827000,1433670,8260670
6828,2021-08-27,2,2,6828000,1433880,8261880
6829,2022-11-24,3,2,6829000,1434090,8263090
6830,2020-07-25,1,1,6830000,1434300,8264300
6831,2024-04-19,3,3,6831000,1434510,8265510
6832,2020-08-01,3,1,6832000,1434720,8266720
6833,2022-04-27,1,3,6833000,1434930,8267930
6834,2020-08-03,1,2,6834000,1435140,8269140
6835,2024-01-09,2,1,6835000,1435350,8270350
6836,2023-07-18,3,2,6836000,1435560,8271560
6837,2021-11-20,2,2,6837000,1435770,8272770
6838,2020-04-15,2,3,6838000,1435980,8273980
6839,2020-06-25,2,2,6839000,1436190,8275190
6840,2022-08-27,1,3,6840000,1436400,8276400
6841,2023-10-15,1,3,6841000,1436610,8277610
6842,2021-02-09,2,3,6842000,1436820,8278820
6843,2021-01-19,3,2,6843000,1437030,8280030
6844,2024-08-18,2,2,6844000,1437240,8281240
6845,2020-06-29,3,1,6845000,1437450,8282450
6846,2021-10-11,2,1,6846000,1437660,8283660
6847,2020-11-25,2,3,6847000,1437870,8284870
6848,2024-09-05,3,2,6848000,1438080,8286080
6849,2024-01-21,3,2,6849000,1438290,8287290
6850,2023-11-23,3,1,6850000,1438500,8288500
6851,2023-01-12,1,2,6851000,1438710,8289710
6852,2020-03-31,3,1,6852000,1438920,8290920
6853,2022-08-28,2,3,6853000,1439130,8292130
6854,2024-10-17,1,1,6854000,1439340,8293340
6855,2020-02-08,1,3,6855000,1439550,8294550
6856,2023-07-29,1,2,6856000,1439760,8295760
6857,2020-10-27,3,2,6857000,1439970,8296970
6858,2021-09-30,3,3,6858000,1440180,8298180
6859,2020-08-14,1,1,6859000,1440390,8299390
6860,2022-12-12,2,2,6860000,1440600,8300600
6861,2023-07-03,3,3,6861000,1440810,8301810
6862,2021-05-29,3,1,6862000,1441020,8303020
6863,2024-09-22,2,3,6863000,1441230,8304230
6864,2023-10-27,1,2,6864000,1441440,8305440
6865,2024-05-12,3,1,6865000,1441650,8306650
6866,2020-03-03,3,3,6866000,1441860,8307860
6867,2024-09-29,2,1,6867000,1442070,8309070
6868,2022-08-02,1,1,6868000,1442280,8310280
6869,2024-02-27,2,3,6869000,1442490,8311490
6870,2022-12-27,3,2,6870000,1442700,8312700
6871,2020-06-19,1,2,6871000,1442910,8313910
6872,2021-03-20,2,1,6872000,1443120,8315120
6873,2023-07-12,1,2,6873000,1443330,8316330
6874,2020-10-08,3,3,6874000,1443540,8317540
6875,2021-11-21,1,3,6875000,1443750,8318750
6876,2024-09-27,3,2,6876000,1443960,8319960
6877,2022-03-02,3,1,6877000,1444170,8321170
6878,2020-10-13,3,3,6878000,1444380,8322380
6879,2024-12-13,1,3,6879000,1444590,8323590
6880,2020-12-08,2,3,6880000,1444800,8324800
6881,2024-03-14,1,1,6881000,1445010,8326010
6882,2024-05-22,2,1,6882000,1445220,8327220
6883,2021-11-25,2,3,6883000,1445430,8328430
6884,2023-09-21,3,3,6884000,1445640,8329640
6885,2020-05-24,3,2,6885000,1445850,8330850
6886,2023-12-09,2,3,6886000,1446060,8332060
6887,2021-05-17,2,1,6887000,1446270,8333270
6888,2020-09-16,3,3,6888000,1446480,8334480
6889,2023-06-05,1,3,6889000,1446690,8335690
6890,2021-06-11,1,2,6890000,1446900,8336900
6891,2024-09-18,3,2,6891000,1447110,8338110
6892,2022-09-29,3,2,6892000,1447320,8339320
6893,2020-06-07,1,1,6893000,1447530,8340530
6894,2021-12-24,3,1,6894000,1447740,8341740
6895,2023-10-18,3,2,6895000,1447950,8342950
6896,2024-03-23,3,1,6896000,1448160,8344160
6897,2023-04-17,1,3,6897000,1448370,8345370
6898,2022-03-28,3,3,6898000,1448580,8346580
6899,2020-05-29,2,2,6899000,1448790,8347790
6900,2023-09-03,1,2,6900000,1449000,8349000
6901,2022-07-24,2,2,6901000,1449210,8350210
6902,2020-05-03,3,2,6902000,1449420,8351420
6903,2024-11-13,2,2,6903000,1449630,8352630
6904,2023-02-03,2,2,6904000,1449840,8353840
6905,2021-12-12,1,1,6905000,1450050,8355050
6906,2022-06-12,1,3,6906000,1450260,8356260
6907,2023-07-15,2,1,6907000,1450470,8357470
6908,2022-08-10,1,3,6908000,1450680,8358680
6909,2023-01-24,2,1,6909000,1450890,8359890
6910,2021-04-23,2,3,6910000,1451100,8361100
6911,2024-06-21,1,3,6911000,1451310,8362310
6912,2024-05-18,2,3,6912000,1451520,8363520
6913,2022-08-24,2,1,6913000,1451730,8364730
6914,2023-01-11,1,3,6914000,1451940,8365940
6915,2024-06-07,3,3,6915000,1452150,8367150
6916,2024-02-21,1,1,6916000,1452360,8368360
6917,2023-09-19,2,3,6917000,1452570,8369570
6918,2022-03-14,2,3,6918000,1452780,8370780
6919,2024-02-12,1,1,6919000,1452990,8371990
6920,2020-05-10,3,1,6920000,1453200,8373200
6921,2024-06-27,3,3,6921000,1453410,8374410
6922,2020-08-13,3,3,6922000,1453620,8375620
6923,2023-01-01,1,2,6923000,1453830,8376830
6924,2021-05-26,1,1,6924000,1454040,8378040
6925,2024-12-11,3,1,6925000,1454250,8379250
6926,2024-06-23,1,1,6926000,1454460,8380460
6927,2023-06-05,1,1,6927000,1454670,8381670
6928,2020-03-07,2,1,6928000,1454880,8382880
6929,2022-07-21,1,3,6929000,1455090,8384090
6930,2024-05-04,3,2,6930000,1455300,8385300
6931,2024-09-13,3,3,6931000,1455510,8386510
6932,2023-04-25,2,3,6932000,1455720,8387720
6933,2020-09-28,1,2,6933000,1455930,8388930
6934,2021-09-10,3,3,6934000,1456140,8390140
6935,2023-11-02,2,3,6935000,1456350,8391350
6936,2023-08-09,3,3,6936000,1456560,8392560
6937,2023-06-16,2,1,6937000,1456770,8393770
6938,2024-04-15,1,2,6938000,1456980,8394980
6939,2023-09-26,3,1,6939000,1457190,8396190
6940,2020-01-19,3,2,6940000,1457400,8397400
6941,2021-10-20,1,1,6941000,1457610,8398610
6942,2024-01-23,1,2,6942000,1457820,8399820
6943,2020-09-20,2,1,6943000,1458030,8401030
6944,2021-09-20,1,1,6944000,1458240,8402240
6945,2024-07-05,3,2,6945000,1458450,8403450
6946,2024-05-23,3,2,6946000,1458660,8404660
6947,2022-02-27,2,2,6947000,1458870,8405870
6948,2024-07-03,2,3,6948000,1459080,8407080
6949,2024-08-18,1,2,6949000,1459290,8408290
6950,2024-03-04,3,1,6950000,1459500,8409500
6951,2021-10-08,1,3,6951000,1459710,8410710
6952,2024-05-05,1,1,6952000,1459920,8411920
6953,2024-09-14,3,3,6953000,1460130,8413130
6954,2023-01-25,1,2,6954000,1460340,8414340
6955,2021-05-13,1,3,6955000,1460550,8415550
6956,2021-06-19,2,3,6956000,1460760,8416760
6957,2020-01-28,3,1,6957000,1460970,8417970
6958,2022-07-14,3,2,6958000,1461180,8419180
6959,2022-01-12,2,2,6959000,1461390,8420390
6960,2024-10-23,3,1,6960000,1461600,8421600
6961,2020-05-17,3,2,6961000,1461810,8422810
6962,2024-09-19,2,2,6962000,1462020,8424020
6963,2020-04-16,1,3,6963000,1462230,8425230
6964,2022-03-18,1,3,6964000,1462440,8426440
6965,2022-07-03,2,1,6965000,1462650,8427650
6966,2023-08-25,3,1,6966000,1462860,8428860
6967,2023-10-06,1,1,6967000,1463070,8430070
6968,2020-11-02,3,2,6968000,1463280,8431280
6969,2021-05-24,1,3,6969000,1463490,8432490
6970,2022-03-06,1,3,6970000,1463700,8433700
6971,2021-11-06,2,2,6971000,1463910,8434910
6972,2022-11-23,3,3,6972000,1464120,8436120
6973,2021-03-02,1,2,6973000,1464330,8437330
6974,2021-02-22,2,1,6974000,1464540,8438540
6975,2023-07-08,2,1,6975000,1464750,8439750
6976,2020-05-09,1,2,6976000,1464960,8440960
6977,2020-11-26,1,3,6977000,1465170,8442170
6978,2022-09-06,1,3,6978000,1465380,8443380
6979,2021-01-22,2,2,6979000,1465590,8444590
6980,2020-07-31,1,3,6980000,1465800,8445800
6981,2021-06-28,1,1,6981000,1466010,8447010
6982,2023-11-09,3,2,6982000,1466220,8448220
6983,2021-01-06,3,1,6983000,1466430,8449430
6984,2023-08-29,1,1,6984000,1466640,8450640
6985,2020-02-16,3,2,6985000,1466850,8451850
6986,2024-03-19,3,1,6986000,1467060,8453060
6987,2021-11-27,2,3,6987000,1467270,8454270
6988,2023-08-30,3,1,6988000,1467480,8455480
6989,2024-01-24,1,3,6989000,1467690,8456690
6990,2023-11-07,1,3,6990000,1467900,8457900
6991,2021-01-14,3,2,6991000,1468110,8459110
6992,2023-10-10,3,2,6992000,1468320,8460320
6993,2024-05-26,3,3,6993000,1468530,8461530
6994,2024-03-01,2,2,6994000,1468740,8462740
6995,2024-12-04,2,2,6995000,1468950,8463950
6996,2020-05-13,2,1,6996000,1469160,8465160
6997,2020-09-04,1,2,6997000,1469370,8466370
6998,2021-06-27,3,2,6998000,1469580,8467580
6999,2022-07-25,1,2,6999000,1469790,8468790
7000,2021-02-22,2,1,7000000,1470000,8470000
7001,2024-11-26,2,3,7001000,1470210,8471210
7002,2020-10-29,2,1,7002000,1470420,8472420
7003,2024-05-27,3,3,7003000,1470630,8473630
7004,2022-08-15,1,2,7004000,1470840,8474840
7005,2023-10-03,3,2,7005000,1471050,8476050
7006,2024-04-09,3,3,7006000,1471260,8477260
7007,2024-04-26,1,3,7007000,1471470,8478470
7008,2023-03-19,1,3,7008000,1471680,8479680
7009,2023-01-18,2,2,7009000,1471890,8480890
7010,2021-11-21,1,3,7010000,1472100,8482100
7011,2023-12-13,2,3,7011000,1472310,8483310
7012,2024-08-18,2,3,7012000,1472520,8484520
7013,2021-06-27,3,1,7013000,1472730,8485730
7014,2024-09-04,3,3,7014000,1472940,8486940
7015,2021-10-29,1,3,7015000,1473150,8488150
7016,2022-08-05,1,3,7016000,1473360,8489360
7017,2020-03-23,2,2,7017000,1473570,8490570
7018,2023-06-20,1,1,7018000,1473780,8491780
7019,2021-09-23,2,2,7019000,1473990,8492990
7020,2021-09-25,1,3,7020000,1474200,8494200
7021,2024-01-04,3,1,7021000,1474410,8495410
7022,2022-12-16,3,3,7022000,1474620,8496620
7023,2024-08-22,2,1,7023000,1474830,8497830
7024,2020-03-10,1,1,7024000,1475040,8499040
7025,2023-03-16,1,1,7025000,1475250,8500250
7026,2023-06-27,3,1,7026000,1475460,8501460
7027,2021-01-10,2,3,7027000,1475670,8502670
7028,2020-12-17,3,2,7028000,1475880,8503880
7029,2024-12-18,2,2,7029000,1476090,8505090
7030,2024-06-04,1,3,7030000,1476300,8506300
7031,2022-02-22,3,1,7031000,1476510,8507510
7032,2023-02-14,3,3,7032000,1476720,8508720
7033,2024-10-27,3,2,7033000,1476930,8509930
7034,2022-06-29,1,3,7034000,1477140,8511140
7035,2021-02-03,1,1,7035000,1477350,8512350
7036,2022-01-20,1,3,7036000,1477560,8513560
7037,2023-02-15,3,3,7037000,1477770,8514770
7038,2020-07-18,3,3,7038000,1477980,8515980
7039,2021-07-22,2,1,7039000,1478190,8517190
7040,2024-02-13,1,2,7040000,1478400,8518400
7041,2020-01-20,3,3,7041000,1478610,8519610
7042,2023-07-14,1,2,7042000,1478820,8520820
7043,2020-06-01,2,2,7043000,1479030,8522030
7044,2024-10-12,1,1,7044000,1479240,8523240
7045,2021-05-13,1,1,7045000,1479450,8524450
7046,2023-04-07,2,3,7046000,1479660,8525660
7047,2024-07-23,1,1,7047000,1479870,8526870
7048,2020-07-21,3,2,7048000,1480080,8528080
7049,2023-01-28,2,1,7049000,1480290,8529290
7050,2023-08-12,2,3,7050000,1480500,8530500
7051,2023-12-20,2,1,7051000,1480710,8531710
7052,2020-12-01,2,3,7052000,1480920,8532920
7053,2020-10-31,1,3,7053000,1481130,8534130
7054,2023-03-11,1,1,7054000,1481340,8535340
7055,2024-11-01,3,1,7055000,1481550,8536550
7056,2023-10-03,2,2,7056000,1481760,8537760
7057,2021-03-29,1,2,7057000,1481970,8538970
7058,2020-01-23,3,1,7058000,1482180,8540180
7059,2023-05-24,2,2,7059000,1482390,8541390
7060,2023-06-22,2,3,7060000,1482600,8542600
7061,2022-03-10,2,2,7061000,1482810,8543810
7062,2023-11-05,3,3,7062000,1483020,8545020
7063,2021-03-29,1,3,7063000,1483230,8546230
7064,2021-12-05,2,1,7064000,1483440,8547440
7065,2024-04-26,1,3,7065000,1483650,8548650
7066,2021-07-09,1,3,7066000,1483860,8549860
7067,2024-03-27,1,3,7067000,1484070,8551070
7068,2024-08-13,3,2,7068000,1484280,8552280
7069,2023-11-21,1,1,7069000,1484490,8553490
7070,2022-07-15,1,2,7070000,1484700,8554700
7071,2020-12-05,2,2,7071000,1484910,8555910
7072,2024-12-23,2,2,7072000,1485120,8557120
7073,2024-11-22,1,2,7073000,1485330,8558330
7074,2020-04-01,1,2,7074000,1485540,8559540
7075,2022-11-21,1,2,7075000,1485750,8560750
7076,2023-02-02,1,3,7076000,1485960,8561960
7077,2023-10-11,3,1,7077000,1486170,8563170
7078,2024-04-19,1,3,7078000,1486380,8564380
7079,2022-11-03,1,1,7079000,1486590,8565590
7080,2022-02-21,3,3,7080000,1486800,8566800
7081,2021-12-23,2,2,7081000,1487010,8568010
7082,2020-02-22,1,3,7082000,1487220,8569220
7083,2024-10-31,3,3,7083000,1487430,8570430
7084,2020-11-24,2,1,7084000,1487640,8571640
7085,2024-05-25,1,3,7085000,1487850,8572850
7086,2022-08-13,2,2,7086000,1488060,8574060
7087,2024-10-10,2,3,7087000,1488270,8575270
7088,2020-08-14,3,3,7088000,1488480,8576480
7089,2023-11-18,2,1,7089000,1488690,8577690
7090,2020-07-24,3,2,7090000,1488900,8578900
7091,2024-07-23,3,3,7091000,1489110,8580110
7092,2021-12-03,2,1,7092000,1489320,8581320
7093,2022-01-05,3,3,7093000,1489530,8582530
7094,2022-12-05,1,3,7094000,1489740,8583740
7095,2022-06-06,1,2,7095000,1489950,8584950
7096,2023-09-18,1,1,7096000,1490160,8586160
7097,2024-09-05,2,3,7097000,1490370,8587370
7098,2021-02-18,2,3,7098000,1490580,8588580
7099,2022-11-30,1,1,7099000,1490790,8589790
7100,2020-11-15,1,2,7100000,1491000,8591000
7101,2021-10-19,1,2,7101000,1491210,8592210
7102,2023-01-12,1,1,7102000,1491420,8593420
7103,2022-07-17,3,2,7103000,1491630,8594630
7104,2020-10-07,2,3,7104000,1491840,8595840
7105,2020-09-27,1,2,7105000,1492050,8597050
7106,2024-02-14,2,1,7106000,1492260,8598260
7107,2021-05-19,3,2,7107000,1492470,8599470
7108,2023-08-08,2,2,7108000,1492680,8600680
7109,2020-07-31,3,1,7109000,1492890,8601890
7110,2024-04-21,3,2,7110000,1493100,8603100
7111,2022-05-08,1,2,7111000,1493310,8604310
7112,2024-12-02,2,3,7112000,1493520,8605520
7113,2022-10-18,1,1,7113000,1493730,8606730
7114,2020-05-27,3,3,7114000,1493940,8607940
7115,2024-02-08,3,2,7115000,1494150,8609150
7116,2022-09-09,1,2,7116000,1494360,8610360
7117,2023-06-17,2,2,7117000,1494570,8611570
7118,2021-09-06,3,3,7118000,1494780,8612780
7119,2022-11-15,2,1,7119000,1494990,8613990
7120,2020-08-05,3,1,7120000,1495200,8615200
7121,2024-03-19,3,1,7121000,1495410,8616410
7122,2021-08-01,2,2,7122000,1495620,8617620
7123,2024-01-03,3,2,7123000,1495830,8618830
7124,2022-12-14,1,3,7124000,1496040,8620040
7125,2020-05-24,2,3,7125000,1496250,8621250
7126,2023-11-04,2,1,7126000,1496460,8622460
7127,2023-03-25,2,3,7127000,1496670,8623670
7128,2020-01-19,2,2,7128000,1496880,8624880
7129,2024-02-29,2,2,7129000,1497090,8626090
7130,2024-10-29,2,1,7130000,1497300,8627300
7131,2023-11-20,3,2,7131000,1497510,8628510
7132,2020-09-25,2,1,7132000,1497720,8629720
7133,2021-10-19,2,2,7133000,1497930,8630930
7134,2020-06-28,2,3,7134000,1498140,8632140
7135,2023-10-29,3,3,7135000,1498350,8633350
7136,2023-04-28,2,3,7136000,1498560,8634560
7137,2020-12-06,3,1,7137000,1498770,8635770
7138,2023-09-03,1,3,7138000,1498980,8636980
7139,2022-04-02,1,2,7139000,1499190,8638190
7140,2020-02-29,3,2,7140000,1499400,8639400
7141,2023-04-25,1,3,7141000,1499610,8640610
7142,2023-08-08,1,3,7142000,1499820,8641820
7143,2020-07-01,1,3,7143000,1500030,8643030
7144,2021-12-10,2,3,7144000,1500240,8644240
7145,2024-05-19,3,1,7145000,1500450,8645450
7146,2022-08-30,3,3,7146000,1500660,8646660
7147,2023-06-17,2,3,7147000,1500870,8647870
7148,2022-05-18,2,1,7148000,1501080,8649080
7149,2023-12-31,1,3,7149000,1501290,8650290
7150,2023-07-17,2,1,7150000,1501500,8651500
7151,2023-05-23,1,2,7151000,1501710,8652710
7152,2023-10-09,3,2,7152000,1501920,8653920
7153,2020-01-28,1,1,7153000,1502130,8655130
7154,2022-08-03,3,2,7154000,1502340,8656340
7155,2020-12-24,1,3,7155000,1502550,8657550
7156,2024-10-21,3,1,7156000,1502760,8658760
7157,2020-11-04,2,2,7157000,1502970,8659970
7158,2020-03-21,2,2,7158000,1503180,8661180
7159,2024-01-06,2,2,7159000,1503390,8662390
7160,2022-02-08,2,2,7160000,1503600,8663600
7161,2021-02-12,3,1,7161000,1503810,8664810
7162,2023-03-19,2,2,7162000,1504020,8666020
7163,2020-09-19,2,2,7163000,1504230,8667230
7164,2021-06-04,3,1,7164000,1504440,8668440
7165,2022-03-08,1,2,7165000,1504650,8669650
7166,2023-08-16,2,3,7166000,1504860,8670860
7167,2020-08-13,3,1,7167000,1505070,8672070
7168,2023-05-30,1,3,7168000,1505280,8673280
7169,2020-07-11,3,1,7169000,1505490,8674490
7170,2020-07-27,1,2,7170000,1505700,8675700
7171,2022-06-28,3,2,7171000,1505910,8676910
7172,2024-09-22,1,1,7172000,1506120,8678120
7173,2022-01-20,3,3,7173000,1506330,8679330
7174,2024-09-23,1,1,7174000,1506540,8680540
7175,2022-09-29,3,2,7175000,1506750,8681750
7176,2022-11-30,2,1,7176000,1506960,8682960
7177,2023-08-25,3,2,7177000,1507170,8684170
7178,2022-06-29,1,3,7178000,1507380,8685380
7179,2020-10-06,1,1,7179000,1507590,8686590
7180,2021-04-04,3,3,7180000,1507800,8687800
7181,2022-08-22,1,1,7181000,1508010,8689010
7182,2022-07-04,3,3,7182000,1508220,8690220
7183,2024-03-27,3,2,7183000,1508430,8691430
7184,2023-04-26,1,3,7184000,1508640,8692640
7185,2024-02-24,2,2,7185000,1508850,8693850
7186,2022-05-05,2,2,7186000,1509060,8695060
7187,2020-01-15,2,1,7187000,1509270,8696270
7188,2021-07-25,2,1,7188000,1509480,8697480
7189,2023-02-26,2,2,7189000,1509690,8698690
7190,2024-03-13,3,2,7190000,1509900,8699900
7191,2020-06-02,1,1,7191000,1510110,8701110
7192,2021-05-07,3,1,7192000,1510320,8702320
7193,2024-10-25,3,1,7193000,1510530,8703530
7194,2024-06-06,2,3,7194000,1510740,8704740
7195,2023-05-16,2,2,7195000,1510950,8705950
7196,2023-10-20,2,3,7196000,1511160,8707160
7197,2021-11-13,1,3,7197000,1511370,8708370
7198,2020-02-22,1,1,7198000,1511580,8709580
7199,2022-07-23,1,3,7199000,1511790,8710790
7200,2024-06-11,3,3,7200000,1512000,8712000
7201,2021-07-29,2,1,7201000,1512210,8713210
7202,2024-06-06,1,2,7202000,1512420,8714420
7203,2024-03-03,3,3,7203000,1512630,8715630
7204,2021-08-19,2,1,7204000,1512840,8716840
7205,2024-12-23,1,1,7205000,1513050,8718050
7206,2024-07-20,3,2,7206000,1513260,8719260
7207,2022-01-05,3,3,7207000,1513470,8720470
7208,2024-01-24,2,2,7208000,1513680,8721680
7209,2024-05-10,1,2,7209000,1513890,8722890
7210,2023-04-08,3,2,7210000,1514100,8724100
7211,2022-09-28,1,1,7211000,1514310,8725310
7212,2022-04-07,3,3,7212000,1514520,8726520
7213,2024-03-14,3,2,7213000,1514730,8727730
7214,2022-11-05,3,3,7214000,1514940,8728940
7215,2021-01-06,3,3,7215000,1515150,8730150
7216,2024-10-11,1,2,7216000,1515360,8731360
7217,2024-02-03,1,1,7217000,1515570,8732570
7218,2020-09-21,3,2,7218000,1515780,8733780
7219,2020-01-28,2,3,7219000,1515990,8734990
7220,2024-03-31,1,2,7220000,1516200,8736200
7221,2021-03-19,2,1,7221000,1516410,8737410
7222,2020-02-02,2,2,7222000,1516620,8738620
7223,2022-04-10,1,2,7223000,1516830,8739830
7224,2024-09-25,1,3,7224000,1517040,8741040
7225,2023-03-20,2,3,7225000,1517250,8742250
7226,2020-08-02,1,2,7226000,1517460,8743460
7227,2021-03-29,3,1,7227000,1517670,8744670
7228,2023-03-03,2,2,7228000,1517880,8745880
7229,2022-05-14,1,2,7229000,1518090,8747090
7230,2023-06-01,1,2,7230000,1518300,8748300
7231,2023-07-27,1,1,7231000,1518510,8749510
7232,2024-11-18,1,2,7232000,1518720,8750720
7233,2024-04-26,2,3,7233000,1518930,8751930
7234,2023-11-29,2,3,7234000,1519140,8753140
7235,2020-03-30,3,3,7235000,1519350,8754350
7236,2022-05-20,2,1,7236000,1519560,8755560
7237,2021-11-16,1,2,7237000,1519770,8756770
7238,2020-08-07,3,1,7238000,1519980,8757980
7239,2021-07-19,3,2,7239000,1520190,8759190
7240,2022-09-25,1,1,7240000,1520400,8760400
7241,2020-06-12,2,2,7241000,1520610,8761610
7242,2021-07-12,2,2,7242000,1520820,8762820
7243,2021-05-12,3,1,7243000,1521030,8764030
7244,2022-10-11,2,3,7244000,1521240,8765240
7245,2021-07-07,1,1,7245000,1521450,8766450
7246,2020-02-27,3,1,7246000,1521660,8767660
7247,2023-12-10,3,1,7247000,1521870,8768870
7248,2020-12-14,2,3,7248000,1522080,8770080
7249,2020-09-23,2,2,7249000,1522290,8771290
7250,2021-10-26,2,1,7250000,1522500,8772500
7251,2020-10-25,3,1,7251000,1522710,8773710
7252,2024-10-10,2,1,7252000,1522920,8774920
7253,2023-07-17,2,1,7253000,1523130,8776130
7254,2023-05-26,2,1,7254000,1523340,8777340
7255,2023-08-27,1,1,7255000,1523550,8778550
7256,2022-07-19,2,1,7256000,1523760,8779760
7257,2023-08-09,3,2,7257000,1523970,8780970
7258,2021-04-25,2,1,7258000,1524180,8782180
7259,2022-10-22,2,3,7259000,1524390,8783390
7260,2020-10-20,1,2,7260000,1524600,8784600
7261,2023-11-30,1,1,7261000,1524810,8785810
7262,2024-11-23,3,2,7262000,1525020,8787020
7263,2020-01-05,3,1,7263000,1525230,8788230
7264,2022-08-12,2,1,7264000,1525440,8789440
7265,2022-07-13,3,3,7265000,1525650,8790650
7266,2024-01-10,3,2,7266000,1525860,8791860
7267,2021-08-12,3,1,7267000,1526070,8793070
7268,2023-09-26,3,1,7268000,1526280,8794280
7269,2024-04-22,2,1,7269000,1526490,8795490
7270,2024-10-23,2,1,7270000,1526700,8796700
7271,2024-08-27,3,2,7271000,1526910,8797910
7272,2024-10-11,3,3,7272000,1527120,8799120
7273,2024-03-22,1,3,7273000,1527330,8800330
7274,2022-06-04,3,1,7274000,1527540,8801540
7275,2022-06-16,2,3,7275000,1527750,8802750
7276,2020-04-02,2,3,7276000,1527960,8803960
7277,2024-09-07,2,2,7277000,1528170,8805170
7278,2020-07-28,3,3,7278000,1528380,8806380
7279,2021-04-16,2,3,7279000,1528590,8807590
7280,2024-04-10,1,3,7280000,1528800,8808800
7281,2020-10-21,1,3,7281000,1529010,8810010
7282,2024-10-16,1,1,7282000,1529220,8811220
7283,2023-11-13,3,2,7283000,1529430,8812430
7284,2020-04-26,3,2,7284000,1529640,8813640
7285,2022-04-12,1,2,7285000,1529850,8814850
7286,2021-05-12,3,2,7286000,1530060,8816060
7287,2021-08-30,3,3,7287000,1530270,8817270
7288,2020-11-02,2,2,7288000,1530480,8818480
7289,2020-12-20,2,2,7289000,1530690,8819690
7290,2024-03-22,3,1,7290000,1530900,8820900
7291,2020-02-13,2,1,7291000,1531110,8822110
7292,2024-05-20,3,3,7292000,1531320,8823320
7293,2022-09-26,1,3,7293000,1531530,8824530
7294,2021-10-17,3,3,7294000,1531740,8825740
7295,2022-11-09,2,2,7295000,1531950,8826950
7296,2023-04-07,3,3,7296000,1532160,8828160
7297,2020-06-09,2,1,7297000,1532370,8829370
7298,2020-01-26,3,3,7298000,1532580,8830580
7299,2020-03-21,1,1,7299000,1532790,8831790
7300,2022-02-04,3,1,7300000,1533000,8833000
7301,2023-01-08,3,1,7301000,1533210,8834210
7302,2022-07-24,2,2,7302000,1533420,8835420
7303,2021-09-04,1,1,7303000,1533630,8836630
7304,2024-06-05,2,2,7304000,1533840,8837840
7305,2020-03-27,1,3,7305000,1534050,8839050
7306,2021-08-29,3,3,7306000,1534260,8840260
7307,2021-11-22,3,3,7307000,1534470,8841470
7308,2023-03-30,2,3,7308000,1534680,8842680
7309,2023-10-08,1,3,7309000,1534890,8843890
7310,2021-04-22,3,1,7310000,1535100,8845100
7311,2021-04-21,3,2,7311000,1535310,8846310
7312,2021-02-05,1,1,7312000,1535520,8847520
7313,2024-12-07,2,2,7313000,1535730,8848730
7314,2021-04-02,2,1,7314000,1535940,8849940
7315,2022-05-18,1,3,7315000,1536150,8851150
7316,2021-05-15,3,2,7316000,1536360,8852360
7317,2024-10-22,1,2,7317000,1536570,8853570
7318,2021-04-02,2,3,7318000,1536780,8854780
7319,2022-10-07,3,3,7319000,1536990,8855990
7320,2024-09-30,2,2,7320000,1537200,8857200
7321,2023-01-05,3,1,7321000,1537410,8858410
7322,2023-06-25,2,2,7322000,1537620,8859620
7323,2022-10-13,3,1,7323000,1537830,8860830
7324,2020-05-04,3,1,7324000,1538040,8862040
7325,2023-09-04,2,1,7325000,1538250,8863250
7326,2024-05-19,2,1,7326000,1538460,8864460
7327,2023-09-11,1,1,7327000,1538670,8865670
7328,2020-01-27,3,2,7328000,1538880,8866880
7329,2022-05-03,3,1,7329000,1539090,8868090
7330,2022-01-06,2,3,7330000,1539300,8869300
7331,2021-03-31,3,2,7331000,1539510,8870510
7332,2020-12-28,2,3,7332000,1539720,8871720
7333,2022-02-28,2,1,7333000,1539930,8872930
7334,2022-07-25,2,2,7334000,1540140,8874140
7335,2024-08-08,2,3,7335000,1540350,8875350
7336,2023-05-18,3,3,7336000,1540560,8876560
7337,2022-06-09,1,2,7337000,1540770,8877770
7338,2023-02-09,2,2,7338000,1540980,8878980
7339,2024-12-27,2,2,7339000,1541190,8880190
7340,2022-02-24,1,3,7340000,1541400,8881400
7341,2023-12-06,3,1,7341000,1541610,8882610
7342,2021-10-04,1,2,7342000,1541820,8883820
7343,2024-06-05,2,1,7343000,1542030,8885030
7344,2022-11-29,3,3,7344000,1542240,8886240
7345,2023-11-08,3,2,7345000,1542450,8887450
7346,2024-01-08,2,2,7346000,1542660,8888660
7347,2022-08-07,1,2,7347000,1542870,8889870
7348,2024-07-12,3,1,7348000,1543080,8891080
7349,2020-09-12,1,3,7349000,1543290,8892290
7350,2023-04-28,3,2,7350000,1543500,8893500
7351,2022-03-19,3,1,7351000,1543710,8894710
7352,2021-06-02,2,2,7352000,1543920,8895920
7353,2024-05-25,3,1,7353000,1544130,8897130
7354,2024-04-09,2,1,7354000,1544340,8898340
7355,2023-03-02,2,1,7355000,1544550,8899550
7356,2024-05-15,1,3,7356000,1544760,8900760
7357,2021-03-13,3,1,7357000,1544970,8901970
7358,2024-03-25,2,3,7358000,1545180,8903180
7359,2022-12-20,3,3,7359000,1545390,8904390
7360,2023-01-04,3,1,7360000,1545600,8905600
7361,2023-05-23,1,2,7361000,1545810,8906810
7362,2020-08-12,2,2,7362000,1546020,8908020
7363,2023-11-19,1,1,7363000,1546230,8909230
7364,2020-06-14,1,2,7364000,1546440,8910440
7365,2021-04-08,2,3,7365000,1546650,8911650
7366,2022-10-06,1,2,7366000,1546860,8912860
7367,2021-06-06,2,1,7367000,1547070,8914070
7368,2022-02-06,2,3,7368000,1547280,8915280
7369,2022-07-04,1,2,7369000,1547490,8916490
7370,2022-09-01,1,2,7370000,1547700,8917700
7371,2023-02-25,3,1,7371000,1547910,8918910
7372,2020-09-08,2,2,7372000,1548120,8920120
7373,2021-12-14,1,1,7373000,1548330,8921330
7374,2021-11-16,1,3,7374000,1548540,8922540
7375,2023-08-27,2,1,7375000,1548750,8923750
7376,2020-02-28,1,3,7376000,1548960,8924960
7377,2022-11-01,1,2,7377000,1549170,8926170
7378,2024-10-13,2,2,7378000,1549380,8927380
7379,2024-03-07,1,2,7379000,1549590,8928590
7380,2024-08-15,2,3,7380000,1549800,8929800
7381,2024-04-04,3,1,7381000,1550010,8931010
7382,2020-03-20,3,3,7382000,1550220,8932220
7383,2024-05-03,3,1,7383000,1550430,8933430
7384,2022-12-13,3,3,7384000,1550640,8934640
7385,2023-01-12,2,2,7385000,1550850,8935850
7386,2022-09-11,3,2,7386000,1551060,8937060
7387,2020-02-14,1,3,7387000,1551270,8938270
7388,2022-02-10,2,2,7388000,1551480,8939480
7389,2023-05-30,3,3,7389000,1551690,8940690
7390,2020-02-14,2,1,7390000,1551900,8941900
7391,2022-02-25,1,1,7391000,1552110,8943110
7392,2023-08-31,3,2,7392000,1552320,8944320
7393,2021-07-06,1,2,7393000,1552530,8945530
7394,2023-08-18,3,3,7394000,1552740,8946740
7395,2021-11-23,3,1,7395000,1552950,8947950
7396,2022-09-03,1,3,7396000,1553160,8949160
7397,2021-01-06,3,1,7397000,1553370,8950370
7398,2023-11-02,2,1,7398000,1553580,8951580
7399,2024-04-15,1,2,7399000,1553790,8952790
7400,2020-12-15,3,2,7400000,1554000,8954000
7401,2022-05-03,2,1,7401000,1554210,8955210
7402,2023-09-14,3,1,7402000,1554420,8956420
7403,2022-09-21,3,3,7403000,1554630,8957630
7404,2023-01-22,2,1,7404000,1554840,8958840
7405,2021-06-08,1,3,7405000,1555050,8960050
7406,2020-12-19,3,3,7406000,1555260,8961260
7407,2020-06-01,3,3,7407000,1555470,8962470
7408,2021-01-13,2,3,7408000,1555680,8963680
7409,2024-07-05,3,1,7409000,1555890,8964890
7410,2024-03-21,3,2,7410000,1556100,8966100
7411,2024-11-18,1,2,7411000,1556310,8967310
7412,2024-01-02,1,2,7412000,1556520,8968520
7413,2023-08-25,1,3,7413000,1556730,8969730
7414,2020-09-04,3,2,7414000,1556940,8970940
7415,2021-06-05,3,2,7415000,1557150,8972150
7416,2023-01-18,1,2,7416000,1557360,8973360
7417,2021-09-19,1,1,7417000,1557570,8974570
7418,2020-12-03,3,2,7418000,1557780,8975780
7419,2024-05-20,3,2,7419000,1557990,8976990
7420,2022-05-24,2,1,7420000,1558200,8978200
7421,2024-05-13,1,1,7421000,1558410,8979410
7422,2023-06-25,3,3,7422000,1558620,8980620
7423,2021-07-18,3,3,7423000,1558830,8981830
7424,2024-01-14,2,1,7424000,1559040,8983040
7425,2020-02-17,1,1,7425000,1559250,8984250
7426,2020-11-27,3,1,7426000,1559460,8985460
7427,2023-10-17,3,3,7427000,1559670,8986670
7428,2020-01-06,3,1,7428000,1559880,8987880
7429,2023-04-24,1,1,7429000,1560090,8989090
7430,2021-05-07,1,1,7430000,1560300,8990300
7431,2022-03-08,1,3,7431000,1560510,8991510
7432,2023-05-22,1,1,7432000,1560720,8992720
7433,2022-10-15,2,3,7433000,1560930,8993930
7434,2021-06-07,3,1,7434000,1561140,8995140
7435,2020-04-05,2,1,7435000,1561350,8996350
7436,2023-08-31,1,2,7436000,1561560,8997560
7437,2020-09-27,1,2,7437000,1561770,8998770
7438,2021-11-06,1,3,7438000,1561980,8999980
7439,2022-11-09,1,2,7439000,1562190,9001190
7440,2024-08-08,3,3,7440000,1562400,9002400
7441,2021-05-10,3,2,7441000,1562610,9003610
7442,2023-11-01,1,3,7442000,1562820,9004820
7443,2024-10-22,2,1,7443000,1563030,9006030
7444,2020-11-29,2,1,7444000,1563240,9007240
7445,2020-07-26,2,3,7445000,1563450,9008450
7446,2023-12-18,3,1,7446000,1563660,9009660
7447,2022-06-27,2,1,7447000,1563870,9010870
7448,2022-05-15,2,1,7448000,1564080,9012080
7449,2024-12-21,3,2,7449000,1564290,9013290
7450,2024-07-16,2,1,7450000,1564500,9014500
7451,2021-03-13,1,3,7451000,1564710,9015710
7452,2021-03-03,2,2,7452000,1564920,9016920
7453,2022-10-19,2,2,7453000,1565130,9018130
7454,2021-07-26,1,1,7454000,1565340,9019340
7455,2021-09-20,3,1,7455000,1565550,9020550
7456,2022-08-21,2,1,7456000,1565760,9021760
7457,2023-04-11,3,2,7457000,1565970,9022970
7458,2023-05-06,2,1,7458000,1566180,9024180
7459,2024-04-20,1,2,7459000,1566390,9025390
7460,2023-12-07,1,1,7460000,1566600,9026600
7461,2023-05-12,3,3,7461000,1566810,9027810
7462,2023-01-12,1,2,7462000,1567020,9029020
7463,2020-08-24,2,1,7463000,1567230,9030230
7464,2023-11-30,2,2,7464000,1567440,9031440
7465,2022-10-06,2,2,7465000,1567650,9032650
7466,2021-03-06,1,2,7466000,1567860,9033860
7467,2023-08-16,2,1,7467000,1568070,9035070
7468,2024-10-30,1,3,7468000,1568280,9036280
7469,2024-11-09,3,2,7469000,1568490,9037490
7470,2024-07-10,1,2,7470000,1568700,9038700
7471,2020-10-04,2,3,7471000,1568910,9039910
7472,2024-05-11,2,3,7472000,1569120,9041120
7473,2022-04-28,3,1,7473000,1569330,9042330
7474,2021-11-18,3,2,7474000,1569540,9043540
7475,2024-06-20,1,1,7475000,1569750,9044750
7476,2021-07-22,3,3,7476000,1569960,9045960
7477,2023-03-19,3,1,7477000,1570170,9047170
7478,2023-06-01,3,2,7478000,1570380,9048380
7479,2024-10-31,3,1,7479000,1570590,9049590
7480,2020-06-23,3,3,7480000,1570800,9050800
7481,2020-03-18,2,2,7481000,1571010,9052010
7482,2024-01-18,1,2,7482000,1571220,9053220
7483,2021-09-08,3,3,7483000,1571430,9054430
7484,2020-12-30,3,2,7484000,1571640,9055640
7485,2020-09-03,2,1,7485000,1571850,9056850
7486,2020-03-12,1,1,7486000,1572060,9058060
7487,2021-12-07,2,1,7487000,1572270,9059270
7488,2024-05-08,2,3,7488000,1572480,9060480
7489,2024-10-18,1,1,7489000,1572690,9061690
7490,2023-06-20,2,2,7490000,1572900,9062900
7491,2022-12-19,3,3,7491000,1573110,9064110
7492,2021-07-25,3,1,7492000,1573320,9065320
7493,2021-07-19,3,2,7493000,1573530,9066530
7494,2020-12-30,3,2,7494000,1573740,9067740
7495,2020-06-17,3,1,7495000,1573950,9068950
7496,2024-04-16,3,2,7496000,1574160,9070160
7497,2021-06-18,3,3,7497000,1574370,9071370
7498,2024-04-05,3,2,7498000,1574580,9072580
7499,2021-12-31,2,3,7499000,1574790,9073790
7500,2021-04-09,2,3,7500000,1575000,9075000
7501,2020-04-24,3,3,7501000,1575210,9076210
7502,2020-01-27,2,3,7502000,1575420,9077420
7503,2024-06-17,1,1,7503000,1575630,9078630
7504,2024-01-05,2,3,7504000,1575840,9079840
7505,2024-01-25,2,2,7505000,1576050,9081050
7506,2022-07-05,1,3,7506000,1576260,9082260
7507,2021-10-27,3,1,7507000,1576470,9083470
7508,2024-04-11,1,2,7508000,1576680,9084680
7509,2021-06-02,2,2,7509000,1576890,9085890
7510,2021-05-31,3,3,7510000,1577100,9087100
7511,2023-02-10,1,2,7511000,1577310,9088310
7512,2022-07-17,3,2,7512000,1577520,9089520
7513,2021-02-04,1,3,7513000,1577730,9090730
7514,2022-04-05,3,2,7514000,1577940,9091940
7515,2020-05-06,3,2,7515000,1578150,9093150
7516,2022-03-11,3,1,7516000,1578360,9094360
7517,2024-02-02,2,2,7517000,1578570,9095570
7518,2022-03-19,1,1,7518000,1578780,9096780
7519,2021-11-17,3,3,7519000,1578990,9097990
7520,2023-10-23,2,1,7520000,1579200,9099200
7521,2024-11-06,1,2,7521000,1579410,9100410
7522,2023-07-08,3,3,7522000,1579620,9101620
7523,2022-10-14,3,1,7523000,1579830,9102830
7524,2021-10-15,1,2,7524000,1580040,9104040
7525,2022-11-25,1,2,7525000,1580250,9105250
7526,2023-01-08,3,1,7526000,1580460,9106460
7527,2022-02-22,1,3,7527000,1580670,9107670
7528,2022-11-12,2,3,7528000,1580880,9108880
7529,2020-09-10,3,1,7529000,1581090,9110090
7530,2021-05-18,1,2,7530000,1581300,9111300
7531,2020-03-12,3,3,7531000,1581510,9112510
7532,2021-09-22,2,3,7532000,1581720,9113720
7533,2021-12-28,1,3,7533000,1581930,9114930
7534,2023-04-23,2,1,7534000,1582140,9116140
7535,2023-07-21,3,1,7535000,1582350,9117350
7536,2024-06-05,3,1,7536000,1582560,9118560
7537,2020-01-04,2,2,7537000,1582770,9119770
7538,2020-01-04,3,3,7538000,1582980,9120980
7539,2021-07-27,1,3,7539000,1583190,9122190
7540,2022-11-14,2,1,7540000,1583400,9123400
7541,2021-12-10,3,2,7541000,1583610,9124610
7542,2020-11-19,1,2,7542000,1583820,9125820
7543,2024-03-05,2,1,7543000,1584030,9127030
7544,2020-03-06,1,2,7544000,1584240,9128240
7545,2023-07-10,2,3,7545000,1584450,9129450
7546,2023-01-09,3,2,7546000,1584660,9130660
7547,2021-01-14,3,2,7547000,1584870,9131870
7548,2021-02-20,3,1,7548000,1585080,9133080
7549,2022-12-05,2,2,7549000,1585290,9134290
7550,2022-07-03,1,3,7550000,1585500,9135500
7551,2023-05-23,1,2,7551000,1585710,9136710
7552,2023-11-22,3,1,7552000,1585920,9137920
7553,2021-11-23,2,1,7553000,1586130,9139130
7554,2022-11-29,3,1,7554000,1586340,9140340
7555,2022-01-14,2,1,7555000,1586550,9141550
7556,2020-06-09,3,1,7556000,1586760,9142760
7557,2024-04-06,3,2,7557000,1586970,9143970
7558,2024-08-03,3,2,7558000,1587180,9145180
7559,2022-10-29,3,3,7559000,1587390,9146390
7560,2024-02-13,1,2,7560000,1587600,9147600
7561,2022-09-18,1,3,7561000,1587810,9148810
7562,2021-01-01,1,3,7562000,1588020,9150020
7563,2022-07-30,2,1,7563000,1588230,9151230
7564,2024-09-29,1,1,7564000,1588440,9152440
7565,2023-02-11,3,3,7565000,1588650,9153650
7566,2024-10-26,1,2,7566000,1588860,9154860
7567,2023-02-04,1,3,7567000,1589070,9156070
7568,2023-01-18,3,1,7568000,1589280,9157280
7569,2023-08-05,1,1,7569000,1589490,9158490
7570,2023-12-05,1,1,7570000,1589700,9159700
7571,2024-09-12,3,2,7571000,1589910,9160910
7572,2022-12-28,1,2,7572000,1590120,9162120
7573,2021-06-06,1,2,7573000,1590330,9163330
7574,2020-05-06,3,1,7574000,1590540,9164540
7575,2020-07-04,3,3,7575000,1590750,9165750
7576,2022-08-31,1,2,7576000,1590960,9166960
7577,2020-07-14,3,3,7577000,1591170,9168170
7578,2023-06-29,1,2,7578000,1591380,9169380
7579,2021-02-22,2,3,7579000,1591590,9170590
7580,2020-03-28,2,3,7580000,1591800,9171800
7581,2021-12-12,3,2,7581000,1592010,9173010
7582,2020-05-09,3,3,7582000,1592220,9174220
7583,2022-12-26,1,1,7583000,1592430,9175430
7584,2024-12-11,3,3,7584000,1592640,9176640
7585,2024-10-04,1,2,7585000,1592850,9177850
7586,2020-08-20,3,3,7586000,1593060,9179060
7587,2022-12-13,1,1,7587000,1593270,9180270
7588,2022-11-20,1,1,7588000,1593480,9181480
7589,2022-08-08,3,1,7589000,1593690,9182690
7590,2023-05-04,2,2,7590000,1593900,9183900
7591,2020-08-10,3,2,7591000,1594110,9185110
7592,2023-07-20,1,3,7592000,1594320,9186320
7593,2024-05-16,2,1,7593000,1594530,9187530
7594,2023-11-27,2,3,7594000,1594740,9188740
7595,2024-03-27,3,2,7595000,1594950,9189950
7596,2021-01-06,2,3,7596000,1595160,9191160
7597,2023-08-19,2,2,7597000,1595370,9192370
7598,2024-12-24,2,1,7598000,1595580,9193580
7599,2023-12-12,2,1,7599000,1595790,9194790
7600,2023-05-04,1,1,7600000,1596000,9196000
7601,2023-12-23,2,3,7601000,1596210,9197210
7602,2024-05-02,2,2,7602000,1596420,9198420
7603,2022-10-03,2,3,7603000,1596630,9199630
7604,2021-08-01,1,3,7604000,1596840,9200840
7605,2021-09-09,3,1,7605000,1597050,9202050
7606,2021-06-30,3,3,7606000,1597260,9203260
7607,2021-10-12,1,1,7607000,1597470,9204470
7608,2022-03-13,1,3,7608000,1597680,9205680
7609,2022-06-12,3,2,7609000,1597890,9206890
7610,2021-03-18,1,2,7610000,1598100,9208100
7611,2024-10-05,2,2,7611000,1598310,9209310
7612,2024-08-13,2,1,7612000,1598520,9210520
7613,2023-01-06,3,3,7613000,1598730,9211730
7614,2024-12-02,3,2,7614000,1598940,9212940
7615,2024-03-04,2,3,7615000,1599150,9214150
7616,2022-08-31,3,1,7616000,1599360,9215360
7617,2020-07-30,1,2,7617000,1599570,9216570
7618,2020-05-16,1,2,7618000,1599780,9217780
7619,2024-06-26,2,3,7619000,1599990,9218990
7620,2024-09-04,2,3,7620000,1600200,9220200
7621,2020-11-12,3,2,7621000,1600410,9221410
7622,2020-08-03,2,3,7622000,1600620,9222620
7623,2022-01-13,1,3,7623000,1600830,9223830
7624,2021-06-17,1,3,7624000,1601040,9225040
7625,2021-02-12,1,1,7625000,1601250,9226250
7626,2023-09-18,3,3,7626000,1601460,9227460
7627,2024-04-20,1,1,7627000,1601670,9228670
7628,2023-01-09,1,1,7628000,1601880,9229880
7629,2021-06-22,2,2,7629000,1602090,9231090
7630,2020-08-19,1,2,7630000,1602300,9232300
7631,2020-01-14,3,1,7631000,1602510,9233510
7632,2023-08-02,1,3,7632000,1602720,9234720
7633,2023-11-21,3,3,7633000,1602930,9235930
7634,2023-03-08,3,1,7634000,1603140,9237140
7635,2023-01-04,3,3,7635000,1603350,9238350
7636,2020-07-23,3,3,7636000,1603560,9239560
7637,2024-06-28,2,2,7637000,1603770,9240770
7638,2024-10-21,3,3,7638000,1603980,9241980
7639,2024-08-09,1,2,7639000,1604190,9243190
7640,2022-10-23,3,3,7640000,1604400,9244400
7641,2023-05-21,2,1,7641000,1604610,9245610
7642,2023-05-24,1,3,7642000,1604820,9246820
7643,2023-08-01,1,3,7643000,1605030,9248030
7644,2021-10-12,3,2,7644000,1605240,9249240
7645,2021-09-24,1,2,7645000,1605450,9250450
7646,2023-05-20,1,1,7646000,1605660,9251660
7647,2024-09-17,3,3,7647000,1605870,9252870
7648,2020-06-05,2,3,7648000,1606080,9254080
7649,2023-01-06,1,3,7649000,1606290,9255290
7650,2023-03-27,3,2,7650000,1606500,9256500
7651,2021-12-27,3,2,7651000,1606710,9257710
7652,2021-08-05,3,1,7652000,1606920,9258920
7653,2024-09-11,2,1,7653000,1607130,9260130
7654,2022-01-07,1,3,7654000,1607340,9261340
7655,2021-03-01,2,1,7655000,1607550,9262550
7656,2023-09-10,1,3,7656000,1607760,9263760
7657,2023-10-27,3,3,7657000,1607970,9264970
7658,2022-11-17,1,1,7658000,1608180,9266180
7659,2023-01-06,3,1,7659000,1608390,9267390
7660,2024-09-15,3,3,7660000,1608600,9268600
7661,2022-01-02,2,3,7661000,1608810,9269810
7662,2023-09-16,1,3,7662000,1609020,9271020
7663,2021-08-28,2,3,7663000,1609230,9272230
7664,2023-12-13,1,2,7664000,1609440,9273440
7665,2024-08-07,2,2,7665000,1609650,9274650
7666,2023-06-08,1,1,7666000,1609860,9275860
7667,2022-11-07,3,2,7667000,1610070,9277070
7668,2020-07-05,3,1,7668000,1610280,9278280
7669,2020-04-24,1,1,7669000,1610490,9279490
7670,2022-08-23,2,1,7670000,1610700,9280700
7671,2020-09-14,1,3,7671000,1610910,9281910
7672,2020-08-07,3,1,7672000,1611120,9283120
7673,2020-07-04,3,2,7673000,1611330,9284330
7674,2024-06-04,2,3,7674000,1611540,9285540
7675,2023-02-17,1,3,7675000,1611750,9286750
7676,2020-01-29,3,2,7676000,1611960,9287960
7677,2023-11-18,1,1,7677000,1612170,9289170
7678,2023-03-24,1,2,7678000,1612380,9290380
7679,2021-09-20,1,1,7679000,1612590,9291590
7680,2023-04-26,1,3,7680000,1612800,9292800
7681,2024-06-05,2,2,7681000,1613010,9294010
7682,2020-09-28,2,3,7682000,1613220,9295220
7683,2021-10-24,2,2,7683000,1613430,9296430
7684,2024-12-17,1,1,7684000,1613640,9297640
7685,2021-02-01,3,2,7685000,1613850,9298850
7686,2020-10-17,3,3,7686000,1614060,9300060
7687,2023-08-02,3,2,7687000,1614270,9301270
7688,2024-02-14,3,3,7688000,1614480,9302480
7689,2022-10-11,2,1,7689000,1614690,9303690
7690,2022-09-11,2,3,7690000,1614900,9304900
7691,2022-12-25,2,3,7691000,1615110,9306110
7692,2024-01-18,2,3,7692000,1615320,9307320
7693,2020-04-23,1,2,7693000,1615530,9308530
7694,2021-07-03,3,2,7694000,1615740,9309740
7695,2022-12-02,3,1,7695000,1615950,9310950
7696,2021-11-17,3,3,7696000,1616160,9312160
7697,2022-12-20,2,1,7697000,1616370,9313370
7698,2023-10-05,1,1,7698000,1616580,9314580
7699,2023-01-23,1,1,7699000,1616790,9315790
7700,2022-05-18,1,1,7700000,1617000,9317000
7701,2020-08-16,2,2,7701000,1617210,9318210
7702,2020-06-26,3,3,7702000,1617420,9319420
7703,2024-10-04,1,1,7703000,1617630,9320630
7704,2021-05-04,2,3,7704000,1617840,9321840
7705,2021-01-14,3,1,7705000,1618050,9323050
7706,2021-07-27,1,1,7706000,1618260,9324260
7707,2023-12-11,1,3,7707000,1618470,9325470
7708,2023-08-05,3,1,7708000,1618680,9326680
7709,2024-10-17,2,1,7709000,1618890,9327890
7710,2024-08-19,2,2,7710000,1619100,9329100
7711,2022-01-16,2,1,7711000,1619310,9330310
7712,2020-01-18,3,3,7712000,1619520,9331520
7713,2023-01-24,3,1,7713000,1619730,9332730
7714,2020-09-12,1,2,7714000,1619940,9333940
7715,2023-05-21,1,1,7715000,1620150,9335150
7716,2024-10-22,2,2,7716000,1620360,9336360
7717,2022-03-17,2,3,7717000,1620570,9337570
7718,2022-07-28,2,2,7718000,1620780,9338780
7719,2024-11-11,2,2,7719000,1620990,9339990
7720,2024-09-06,1,2,7720000,1621200,9341200
7721,2020-04-20,2,3,7721000,1621410,9342410
7722,2021-02-20,3,2,7722000,1621620,9343620
7723,2023-12-03,3,1,7723000,1621830,9344830
7724,2023-09-17,3,1,7724000,1622040,9346040
7725,2022-04-13,2,3,7725000,1622250,9347250
7726,2023-04-03,2,1,7726000,1622460,9348460
7727,2023-09-01,2,3,7727000,1622670,9349670
7728,2022-02-11,3,3,7728000,1622880,9350880
7729,2024-06-28,3,2,7729000,1623090,9352090
7730,2023-10-01,1,3,7730000,1623300,9353300
7731,2022-10-16,2,3,7731000,1623510,9354510
7732,2022-05-24,3,1,7732000,1623720,9355720
7733,2023-04-24,3,1,7733000,1623930,9356930
7734,2024-11-17,2,2,7734000,1624140,9358140
7735,2022-11-25,3,2,7735000,1624350,9359350
7736,2021-08-07,1,1,7736000,1624560,9360560
7737,2024-07-19,3,3,7737000,1624770,9361770
7738,2024-04-19,2,2,7738000,1624980,9362980
7739,2022-08-29,3,3,7739000,1625190,9364190
7740,2020-10-04,3,1,7740000,1625400,9365400
7741,2024-03-03,1,2,7741000,1625610,9366610
7742,2020-10-14,3,3,7742000,1625820,9367820
7743,2024-12-27,2,2,7743000,1626030,9369030
7744,2023-09-01,2,2,7744000,1626240,9370240
7745,2023-10-17,1,3,7745000,1626450,9371450
7746,2020-02-23,2,3,7746000,1626660,9372660
7747,2022-12-05,3,3,7747000,1626870,9373870
7748,2020-10-10,1,3,7748000,1627080,9375080
7749,2020-05-18,3,3,7749000,1627290,9376290
7750,2023-01-23,1,2,7750000,1627500,9377500
7751,2024-03-07,1,1,7751000,1627710,9378710
7752,2021-02-20,2,3,7752000,1627920,9379920
7753,2022-02-25,2,3,7753000,1628130,9381130
7754,2022-09-19,2,3,7754000,1628340,9382340
7755,2020-10-22,3,2,7755000,1628550,9383550
7756,2024-09-14,1,3,7756000,1628760,9384760
7757,2021-01-03,1,1,7757000,1628970,9385970
7758,2022-11-02,3,3,7758000,1629180,9387180
7759,2023-08-18,3,3,7759000,1629390,9388390
7760,2020-03-08,2,2,7760000,1629600,9389600
7761,2024-03-26,2,1,7761000,1629810,9390810
7762,2021-06-03,1,1,7762000,1630020,9392020
7763,2023-11-01,3,3,7763000,1630230,9393230
7764,2024-10-30,2,2,7764000,1630440,9394440
7765,2021-10-26,1,2,7765000,1630650,9395650
7766,2024-10-21,1,1,7766000,1630860,9396860
7767,2020-05-14,3,1,7767000,1631070,9398070
7768,2021-01-13,3,2,7768000,1631280,9399280
7769,2022-05-20,1,3,7769000,1631490,9400490
7770,2022-05-08,3,3,7770000,1631700,9401700
7771,2022-06-15,3,3,7771000,1631910,9402910
7772,2024-10-09,3,1,7772000,1632120,9404120
7773,2022-04-22,1,2,7773000,1632330,9405330
7774,2023-06-29,1,2,7774000,1632540,9406540
7775,2024-11-17,3,3,7775000,1632750,9407750
7776,2021-11-11,1,3,7776000,1632960,9408960
7777,2023-05-09,2,1,7777000,1633170,9410170
7778,2024-04-28,1,1,7778000,1633380,9411380
7779,2020-12-06,2,3,7779000,1633590,9412590
7780,2023-02-13,1,2,7780000,1633800,9413800
7781,2023-10-20,2,1,7781000,1634010,9415010
7782,2022-11-12,3,2,7782000,1634220,9416220
7783,2022-03-27,1,3,7783000,1634430,9417430
7784,2021-07-13,3,3,7784000,1634640,9418640
7785,2022-10-21,3,2,7785000,1634850,9419850
7786,2020-02-07,1,3,7786000,1635060,9421060
7787,2022-03-14,3,3,7787000,1635270,9422270
7788,2020-05-28,2,2,7788000,1635480,9423480
7789,2024-03-26,3,3,7789000,1635690,9424690
7790,2022-12-14,2,1,7790000,1635900,9425900
7791,2024-10-12,3,3,7791000,1636110,9427110
7792,2023-09-14,1,3,7792000,1636320,9428320
7793,2020-12-25,1,2,7793000,1636530,9429530
7794,2024-05-23,1,2,7794000,1636740,9430740
7795,2022-09-04,3,3,7795000,1636950,9431950
7796,2021-03-15,1,3,7796000,1637160,9433160
7797,2024-09-30,3,3,7797000,1637370,9434370
7798,2023-01-27,2,1,7798000,1637580,9435580
7799,2020-09-11,2,2,7799000,1637790,9436790
7800,2020-04-15,3,2,7800000,1638000,9438000
7801,2024-05-06,2,1,7801000,1638210,9439210
7802,2024-05-29,3,2,7802000,1638420,9440420
7803,2023-08-05,3,2,7803000,1638630,9441630
7804,2021-05-13,2,1,7804000,1638840,9442840
7805,2020-06-11,1,1,7805000,1639050,9444050
7806,2021-09-24,2,1,7806000,1639260,9445260
7807,2024-04-03,3,1,7807000,1639470,9446470
7808,2024-05-16,3,3,7808000,1639680,9447680
7809,2022-03-26,1,1,7809000,1639890,9448890
7810,2020-12-17,2,2,7810000,1640100,9450100
7811,2024-10-31,3,1,7811000,1640310,9451310
7812,2023-08-12,3,1,7812000,1640520,9452520
7813,2024-03-21,2,3,7813000,1640730,9453730
7814,2024-07-19,1,1,7814000,1640940,9454940
7815,2022-09-17,2,2,7815000,1641150,9456150
7816,2021-06-12,2,2,7816000,1641360,9457360
7817,2020-10-12,2,2,7817000,1641570,9458570
7818,2020-09-18,3,2,7818000,1641780,9459780
7819,2023-09-19,3,3,7819000,1641990,9460990
7820,2020-06-20,1,1,7820000,1642200,9462200
7821,2023-11-13,1,1,7821000,1642410,9463410
7822,2022-09-15,2,3,7822000,1642620,9464620
7823,2021-05-03,3,1,7823000,1642830,9465830
7824,2020-07-16,3,2,7824000,1643040,9467040
7825,2021-12-16,3,3,7825000,1643250,9468250
7826,2022-05-21,2,2,7826000,1643460,9469460
7827,2020-04-08,2,3,7827000,1643670,9470670
7828,2024-04-20,1,2,7828000,1643880,9471880
7829,2021-06-06,1,2,7829000,1644090,9473090
7830,2020-06-13,3,1,7830000,1644300,9474300
7831,2020-06-25,3,1,7831000,1644510,9475510
7832,2020-07-15,1,2,7832000,1644720,9476720
7833,2022-02-03,1,3,7833000,1644930,9477930
7834,2024-10-10,2,2,7834000,1645140,9479140
7835,2022-08-04,3,2,7835000,1645350,9480350
7836,2021-03-16,2,3,7836000,1645560,9481560
7837,2021-02-11,3,1,7837000,1645770,9482770
7838,2023-11-25,2,1,7838000,1645980,9483980
7839,2020-02-11,1,2,7839000,1646190,9485190
7840,2020-09-24,3,1,7840000,1646400,9486400
7841,2024-02-23,3,1,7841000,1646610,9487610
7842,2021-12-08,3,1,7842000,1646820,9488820
7843,2020-06-06,2,1,7843000,1647030,9490030
7844,2021-08-31,3,3,7844000,1647240,9491240
7845,2022-10-07,3,3,7845000,1647450,9492450
7846,2023-03-31,1,1,7846000,1647660,9493660
7847,2020-11-09,1,1,7847000,1647870,9494870
7848,2023-12-29,2,3,7848000,1648080,9496080
7849,2023-02-13,3,1,7849000,1648290,9497290
7850,2021-12-25,1,3,7850000,1648500,9498500
7851,2022-09-14,2,2,7851000,1648710,9499710
7852,2022-04-13,1,2,7852000,1648920,9500920
7853,2020-04-16,2,3,7853000,1649130,9502130
7854,2022-02-18,2,3,7854000,1649340,9503340
7855,2020-04-26,1,1,7855000,1649550,9504550
7856,2022-09-15,1,1,7856000,1649760,9505760
7857,2020-12-22,2,1,7857000,1649970,9506970
7858,2020-01-09,2,3,7858000,1650180,9508180
7859,2024-08-11,2,3,7859000,1650390,9509390
7860,2020-10-01,3,3,7860000,1650600,9510600
7861,2022-08-06,1,2,7861000,1650810,9511810
7862,2023-09-18,1,3,7862000,1651020,9513020
7863,2022-06-25,3,1,7863000,1651230,9514230
7864,2024-10-16,1,1,7864000,1651440,9515440
7865,2023-12-04,3,2,7865000,1651650,9516650
7866,2023-02-03,2,3,7866000,1651860,9517860
7867,2021-11-15,2,3,7867000,1652070,9519070
7868,2022-01-13,2,1,7868000,1652280,9520280
7869,2022-09-27,1,1,7869000,1652490,9521490
7870,2023-01-30,1,2,7870000,1652700,9522700
7871,2022-06-30,2,1,7871000,1652910,9523910
7872,2022-08-06,3,2,7872000,1653120,9525120
7873,2020-06-15,1,3,7873000,1653330,9526330
7874,2020-07-09,2,3,7874000,1653540,9527540
7875,2022-08-20,3,3,7875000,1653750,9528750
7876,2021-03-19,2,3,7876000,1653960,9529960
7877,2024-08-31,3,1,7877000,1654170,9531170
7878,2022-07-29,3,2,7878000,1654380,9532380
7879,2020-09-29,2,1,7879000,1654590,9533590
7880,2022-06-17,1,2,7880000,1654800,9534800
7881,2024-10-04,1,3,7881000,1655010,9536010
7882,2022-08-23,1,1,7882000,1655220,9537220
7883,2020-06-05,1,1,7883000,1655430,9538430
7884,2022-07-11,1,2,7884000,1655640,9539640
7885,2024-06-18,3,3,7885000,1655850,9540850
7886,2020-06-14,3,3,7886000,1656060,9542060
7887,2022-03-15,1,1,7887000,1656270,9543270
7888,2021-04-23,3,2,7888000,1656480,9544480
7889,2022-12-02,1,1,7889000,1656690,9545690
7890,2020-04-25,2,2,7890000,1656900,9546900
7891,2024-02-20,3,1,7891000,1657110,9548110
7892,2022-11-23,3,2,7892000,1657320,9549320
7893,2022-01-26,2,2,7893000,1657530,9550530
7894,2021-06-20,2,1,7894000,1657740,9551740
7895,2022-02-28,2,1,7895000,1657950,9552950
7896,2024-12-19,3,3,7896000,1658160,9554160
7897,2024-08-11,3,1,7897000,1658370,9555370
7898,2023-08-24,3,1,7898000,1658580,9556580
7899,2024-03-07,1,2,7899000,1658790,9557790
7900,2022-12-23,1,2,7900000,1659000,9559000
7901,2023-12-25,3,2,7901000,1659210,9560210
7902,2021-09-01,1,1,7902000,1659420,9561420
7903,2022-02-22,2,2,7903000,1659630,9562630
7904,2024-08-23,1,2,7904000,1659840,9563840
7905,2020-05-20,3,3,7905000,1660050,9565050
7906,2023-09-23,2,1,7906000,1660260,9566260
7907,2023-02-16,3,1,7907000,1660470,9567470
7908,2022-08-01,1,3,7908000,1660680,9568680
7909,2021-02-28,2,3,7909000,1660890,9569890
7910,2022-03-28,1,2,7910000,1661100,9571100
7911,2023-06-30,1,3,7911000,1661310,9572310
7912,2023-09-17,1,1,7912000,1661520,9573520
7913,2021-02-22,2,2,7913000,1661730,9574730
7914,2024-11-22,3,3,7914000,1661940,9575940
7915,2020-02-12,3,1,7915000,1662150,9577150
7916,2022-09-18,3,2,7916000,1662360,9578360
7917,2024-01-04,3,1,7917000,1662570,9579570
7918,2021-07-16,3,2,7918000,1662780,9580780
7919,2021-12-10,3,2,7919000,1662990,9581990
7920,2023-10-01,3,3,7920000,1663200,9583200
7921,2022-11-09,2,1,7921000,1663410,9584410
7922,2020-10-12,1,3,7922000,1663620,9585620
7923,2021-03-18,1,2,7923000,1663830,9586830
7924,2022-02-09,2,3,7924000,1664040,9588040
7925,2022-10-27,1,1,7925000,1664250,9589250
7926,2021-08-06,1,3,7926000,1664460,9590460
7927,2022-12-11,3,3,7927000,1664670,9591670
7928,2022-08-20,3,2,7928000,1664880,9592880
7929,2020-05-04,1,3,7929000,1665090,9594090
7930,2022-12-09,2,2,7930000,1665300,9595300
7931,2020-05-05,3,2,7931000,1665510,9596510
7932,2021-02-22,3,3,7932000,1665720,9597720
7933,2023-09-18,3,1,7933000,1665930,9598930
7934,2024-06-06,3,3,7934000,1666140,9600140
7935,2020-01-16,2,3,7935000,1666350,9601350
7936,2023-01-13,2,2,7936000,1666560,9602560
7937,2020-09-14,3,3,7937000,1666770,9603770
7938,2022-01-12,1,1,7938000,1666980,9604980
7939,2021-07-24,2,2,7939000,1667190,9606190
7940,2022-11-06,1,3,7940000,1667400,9607400
7941,2021-10-16,3,1,7941000,1667610,9608610
7942,2021-09-15,1,1,7942000,1667820,9609820
7943,2024-09-28,3,3,7943000,1668030,9611030
7944,2020-08-05,3,3,7944000,1668240,9612240
7945,2020-09-23,2,1,7945000,1668450,9613450
7946,2022-03-22,1,3,7946000,1668660,9614660
7947,2023-09-27,2,2,7947000,1668870,9615870
7948,2020-07-10,2,3,7948000,1669080,9617080
7949,2023-10-23,2,3,7949000,1669290,9618290
7950,2022-03-20,3,2,7950000,1669500,9619500
7951,2020-06-21,3,1,7951000,1669710,9620710
7952,2022-10-24,2,1,7952000,1669920,9621920
7953,2023-05-25,1,3,7953000,1670130,9623130
7954,2024-08-16,3,3,7954000,1670340,9624340
7955,2021-06-09,3,1,7955000,1670550,9625550
7956,2021-10-03,2,3,7956000,1670760,9626760
7957,2022-08-19,2,1,7957000,1670970,9627970
7958,2020-05-16,1,3,7958000,1671180,9629180
7959,2022-01-13,3,1,7959000,1671390,9630390
7960,2021-07-21,1,3,7960000,1671600,9631600
7961,2022-03-24,1,1,7961000,1671810,9632810
7962,2023-12-11,3,1,7962000,1672020,9634020
7963,2024-04-20,1,2,7963000,1672230,9635230
7964,2023-09-03,1,1,7964000,1672440,9636440
7965,2021-09-14,2,2,7965000,1672650,9637650
7966,2021-07-13,2,1,7966000,1672860,9638860
7967,2022-11-21,1,3,7967000,1673070,9640070
7968,2022-09-26,3,1,7968000,1673280,9641280
7969,2021-01-02,2,2,7969000,1673490,9642490
7970,2021-04-27,3,3,7970000,1673700,9643700
7971,2021-10-24,1,1,7971000,1673910,9644910
7972,2024-05-17,2,2,7972000,1674120,9646120
7973,2023-07-23,1,1,7973000,1674330,9647330
7974,2021-04-19,1,2,7974000,1674540,9648540
7975,2024-04-12,2,1,7975000,1674750,9649750
7976,2022-04-16,1,2,7976000,1674960,9650960
7977,2020-06-08,3,1,7977000,1675170,9652170
7978,2020-10-06,2,1,7978000,1675380,9653380
7979,2022-07-30,1,1,7979000,1675590,9654590
7980,2020-01-25,1,2,7980000,1675800,9655800
7981,2023-07-11,2,1,7981000,1676010,9657010
7982,2023-03-29,2,1,7982000,1676220,9658220
7983,2023-08-05,2,2,7983000,1676430,9659430
7984,2020-06-13,1,3,7984000,1676640,9660640
7985,2020-06-19,1,3,7985000,1676850,9661850
7986,2024-10-15,1,1,7986000,1677060,9663060
7987,2022-10-18,3,2,7987000,1677270,9664270
7988,2024-10-13,2,1,7988000,1677480,9665480
7989,2021-12-11,3,1,7989000,1677690,9666690
7990,2021-04-11,2,2,7990000,1677900,9667900
7991,2024-07-09,1,2,7991000,1678110,9669110
7992,2021-11-28,1,3,7992000,1678320,9670320
7993,2021-03-25,2,3,7993000,1678530,9671530
7994,2021-02-14,1,3,7994000,1678740,9672740
7995,2021-09-17,3,2,7995000,1678950,9673950
7996,2020-05-21,3,3,7996000,1679160,9675160
7997,2023-07-03,1,1,7997000,1679370,9676370
7998,2020-07-07,3,3,7998000,1679580,9677580
7999,2022-08-27,2,1,7999000,1679790,9678790
8000,2021-01-23,3,1,8000000,1680000,9680000
8001,2021-10-08,2,3,8001000,1680210,9681210
8002,2021-09-23,1,1,8002000,1680420,9682420
8003,2024-07-08,3,1,8003000,1680630,9683630
8004,2020-10-26,3,2,8004000,1680840,9684840
8005,2021-04-12,3,2,8005000,1681050,9686050
8006,2021-04-13,3,2,8006000,1681260,9687260
8007,2021-04-06,2,2,8007000,1681470,9688470
8008,2020-02-12,3,1,8008000,1681680,9689680
8009,2024-05-13,3,1,8009000,1681890,9690890
8010,2023-02-12,2,2,8010000,1682100,9692100
8011,2024-04-17,2,2,8011000,1682310,9693310
8012,2020-12-16,2,1,8012000,1682520,9694520
8013,2021-11-24,1,1,8013000,1682730,9695730
8014,2022-03-10,2,3,8014000,1682940,9696940
8015,2021-04-04,1,1,8015000,1683150,9698150
8016,2023-08-13,1,2,8016000,1683360,9699360
8017,2024-12-30,2,1,8017000,1683570,9700570
8018,2020-01-03,1,2,8018000,1683780,9701780
8019,2021-06-18,3,1,8019000,1683990,9702990
8020,2022-08-15,1,2,8020000,1684200,9704200
8021,2022-09-07,1,1,8021000,1684410,9705410
8022,2023-11-14,3,2,8022000,1684620,9706620
8023,2021-11-16,1,3,8023000,1684830,9707830
8024,2021-09-28,2,1,8024000,1685040,9709040
8025,2024-07-15,2,2,8025000,1685250,9710250
8026,2024-12-19,3,1,8026000,1685460,9711460
8027,2023-03-31,3,2,8027000,1685670,9712670
8028,2022-05-14,3,3,8028000,1685880,9713880
8029,2022-01-14,3,1,8029000,1686090,9715090
8030,2023-02-14,2,3,8030000,1686300,9716300
8031,2022-09-17,3,2,8031000,1686510,9717510
8032,2024-07-09,1,3,8032000,1686720,9718720
8033,2020-12-24,3,3,8033000,1686930,9719930
8034,2021-10-11,2,2,8034000,1687140,9721140
8035,2023-07-23,1,2,8035000,1687350,9722350
8036,2020-03-27,2,1,8036000,1687560,9723560
8037,2023-08-30,3,1,8037000,1687770,9724770
8038,2020-11-12,2,1,8038000,1687980,9725980
8039,2023-07-02,3,1,8039000,1688190,9727190
8040,2020-12-22,3,3,8040000,1688400,9728400
8041,2022-04-03,1,2,8041000,1688610,9729610
8042,2024-06-14,3,3,8042000,1688820,9730820
8043,2021-02-09,2,1,8043000,1689030,9732030
8044,2023-06-05,2,3,8044000,1689240,9733240
8045,2024-08-12,3,3,8045000,1689450,9734450
8046,2024-03-06,1,2,8046000,1689660,9735660
8047,2022-12-18,1,2,8047000,1689870,9736870
8048,2023-12-28,2,2,8048000,1690080,9738080
8049,2022-04-19,3,1,8049000,1690290,9739290
8050,2024-03-08,2,3,8050000,1690500,9740500
8051,2023-04-20,1,3,8051000,1690710,9741710
8052,2021-04-16,2,1,8052000,1690920,9742920
8053,2022-08-28,2,1,8053000,1691130,9744130
8054,2021-10-27,2,2,8054000,1691340,9745340
8055,2023-04-22,1,1,8055000,1691550,9746550
8056,2021-12-05,2,3,8056000,1691760,9747760
8057,2021-11-06,2,3,8057000,1691970,9748970
8058,2023-12-22,3,1,8058000,1692180,9750180
8059,2024-11-22,2,3,8059000,1692390,9751390
8060,2024-11-03,2,3,8060000,1692600,9752600
8061,2022-01-09,3,2,8061000,1692810,9753810
8062,2020-03-15,1,2,8062000,1693020,9755020
8063,2024-03-04,1,1,8063000,1693230,9756230
8064,2022-03-15,2,3,8064000,1693440,9757440
8065,2023-05-14,2,1,8065000,1693650,9758650
8066,2020-11-06,1,3,8066000,1693860,9759860
8067,2020-06-07,1,1,8067000,1694070,9761070
8068,2020-07-25,2,3,8068000,1694280,9762280
8069,2024-06-07,1,3,8069000,1694490,9763490
8070,2023-11-18,3,2,8070000,1694700,9764700
8071,2023-04-30,1,2,8071000,1694910,9765910
8072,2022-07-20,1,2,8072000,1695120,9767120
8073,2020-10-24,3,3,8073000,1695330,9768330
8074,2024-12-19,1,1,8074000,1695540,9769540
8075,2021-10-20,2,1,8075000,1695750,9770750
8076,2024-06-23,3,1,8076000,1695960,9771960
8077,2021-09-13,2,1,8077000,1696170,9773170
8078,2022-05-07,2,2,8078000,1696380,9774380
8079,2023-08-18,1,1,8079000,1696590,9775590
8080,2021-06-21,2,3,8080000,1696800,9776800
8081,2023-05-24,2,2,8081000,1697010,9778010
8082,2020-04-20,3,1,8082000,1697220,9779220
8083,2024-08-10,3,1,8083000,1697430,9780430
8084,2021-05-29,2,2,8084000,1697640,9781640
8085,2024-12-21,2,2,8085000,1697850,9782850
8086,2024-06-07,2,2,8086000,1698060,9784060
8087,2021-09-05,1,3,8087000,1698270,9785270
8088,2024-08-14,3,2,8088000,1698480,9786480
8089,2023-05-28,1,3,8089000,1698690,9787690
8090,2023-10-27,2,1,8090000,1698900,9788900
8091,2021-06-30,1,1,8091000,1699110,9790110
8092,2023-06-09,2,2,8092000,1699320,9791320
8093,2022-12-07,1,3,8093000,1699530,9792530
8094,2020-12-23,3,1,8094000,1699740,9793740
8095,2024-07-01,3,1,8095000,1699950,9794950
8096,2022-11-19,2,1,8096000,1700160,9796160
8097,2024-07-19,2,3,8097000,1700370,9797370
8098,2023-02-27,1,3,8098000,1700580,9798580
8099,2023-06-15,3,3,8099000,1700790,9799790
8100,2021-12-18,2,1,8100000,1701000,9801000
8101,2020-06-12,3,1,8101000,1701210,9802210
8102,2022-06-18,3,3,8102000,1701420,9803420
8103,2024-01-24,1,1,8103000,1701630,9804630
8104,2022-08-14,2,3,8104000,1701840,9805840
8105,2023-11-04,1,3,8105000,1702050,9807050
8106,2023-09-20,2,1,8106000,1702260,9808260
8107,2020-11-29,3,1,8107000,1702470,9809470
8108,2022-05-29,2,2,8108000,1702680,9810680
8109,2021-04-09,2,3,8109000,1702890,9811890
8110,2020-06-09,3,1,8110000,1703100,9813100
8111,2023-05-13,1,2,8111000,1703310,9814310
8112,2022-02-23,2,1,8112000,1703520,9815520
8113,2022-08-20,1,2,8113000,1703730,9816730
8114,2023-11-14,2,2,8114000,1703940,9817940
8115,2022-06-15,3,1,8115000,1704150,9819150
8116,2020-04-08,1,3,8116000,1704360,9820360
8117,2023-09-24,1,1,8117000,1704570,9821570
8118,2023-05-04,1,1,8118000,1704780,9822780
8119,2022-10-06,1,1,8119000,1704990,9823990
8120,2023-01-20,2,1,8120000,1705200,9825200
8121,2021-06-13,1,2,8121000,1705410,9826410
8122,2020-01-25,3,2,8122000,1705620,9827620
8123,2023-05-03,3,2,8123000,1705830,9828830
8124,2023-07-23,3,1,8124000,1706040,9830040
8125,2021-05-09,2,1,8125000,1706250,9831250
8126,2023-01-10,1,1,8126000,1706460,9832460
8127,2023-04-26,2,2,8127000,1706670,9833670
8128,2021-08-14,1,1,8128000,1706880,9834880
8129,2023-02-10,2,1,8129000,1707090,9836090
8130,2022-05-11,2,1,8130000,1707300,9837300
8131,2020-07-01,1,1,8131000,1707510,9838510
8132,2023-07-24,3,3,8132000,1707720,9839720
8133,2024-06-09,2,1,8133000,1707930,9840930
8134,2021-10-09,1,2,8134000,1708140,9842140
8135,2020-07-22,1,3,8135000,1708350,9843350
8136,2022-10-14,1,3,8136000,1708560,9844560
8137,2024-12-10,3,1,8137000,1708770,9845770
8138,2024-10-03,3,1,8138000,1708980,9846980
8139,2020-08-02,1,2,8139000,1709190,9848190
8140,2020-06-05,3,3,8140000,1709400,9849400
8141,2021-01-25,2,2,8141000,1709610,9850610
8142,2021-12-21,3,3,8142000,1709820,9851820
8143,2021-07-17,3,1,8143000,1710030,9853030
8144,2020-04-25,3,2,8144000,1710240,9854240
8145,2023-09-18,1,1,8145000,1710450,9855450
8146,2021-04-03,2,3,8146000,1710660,9856660
8147,2021-03-20,3,2,8147000,1710870,9857870
8148,2022-09-18,3,1,8148000,1711080,9859080
8149,2024-06-04,3,1,8149000,1711290,9860290
8150,2022-02-21,3,2,8150000,1711500,9861500
8151,2024-03-12,3,2,8151000,1711710,9862710
8152,2022-11-01,3,1,8152000,1711920,9863920
8153,2024-03-03,2,1,8153000,1712130,9865130
8154,2024-05-14,1,3,8154000,1712340,9866340
8155,2020-04-29,3,1,8155000,1712550,9867550
8156,2022-07-23,2,2,8156000,1712760,9868760
8157,2022-09-07,3,1,8157000,1712970,9869970
8158,2020-02-08,3,2,8158000,1713180,9871180
8159,2023-12-13,3,3,8159000,1713390,9872390
8160,2023-04-05,3,3,8160000,1713600,9873600
8161,2024-09-10,1,2,8161000,1713810,9874810
8162,2022-07-18,3,3,8162000,1714020,9876020
8163,2023-07-13,2,3,8163000,1714230,9877230
8164,2021-04-08,3,3,8164000,1714440,9878440
8165,2024-09-18,3,1,8165000,1714650,9879650
8166,2023-12-08,2,3,8166000,1714860,9880860
8167,2020-01-01,1,2,8167000,1715070,9882070
8168,2022-02-23,1,3,8168000,1715280,9883280
8169,2021-03-31,2,3,8169000,1715490,9884490
8170,2024-02-06,2,2,8170000,1715700,9885700
8171,2022-09-10,3,1,8171000,1715910,9886910
8172,2020-10-23,1,2,8172000,1716120,9888120
8173,2020-07-14,3,3,8173000,1716330,9889330
8174,2021-06-12,2,1,8174000,1716540,9890540
8175,2021-12-27,1,2,8175000,1716750,9891750
8176,2023-05-17,3,1,8176000,1716960,9892960
8177,2020-08-13,2,1,8177000,1717170,9894170
8178,2023-11-25,2,2,8178000,1717380,9895380
8179,2022-09-07,2,1,8179000,1717590,9896590
8180,2021-10-16,3,1,8180000,1717800,9897800
8181,2022-12-03,1,1,8181000,1718010,9899010
8182,2022-01-29,2,1,8182000,1718220,9900220
8183,2024-11-30,2,2,8183000,1718430,9901430
8184,2024-07-19,1,3,8184000,1718640,9902640
8185,2020-02-04,2,1,8185000,1718850,9903850
8186,2022-12-17,1,3,8186000,1719060,9905060
8187,2023-06-26,2,1,8187000,1719270,9906270
8188,2020-08-08,3,2,8188000,1719480,9907480
8189,2020-09-24,1,3,8189000,1719690,9908690
8190,2022-07-29,3,2,8190000,1719900,9909900
8191,2024-06-21,3,2,8191000,1720110,9911110
8192,2022-08-06,3,3,8192000,1720320,9912320
8193,2024-05-03,2,1,8193000,1720530,9913530
8194,2022-08-06,3,1,8194000,1720740,9914740
8195,2024-08-27,3,1,8195000,1720950,9915950
8196,2020-12-20,3,1,8196000,1721160,9917160
8197,2022-08-01,1,2,8197000,1721370,9918370
8198,2023-07-23,3,3,8198000,1721580,9919580
8199,2021-06-19,2,1,8199000,1721790,9920790
8200,2022-02-27,3,1,8200000,1722000,9922000
8201,2023-09-20,3,2,8201000,1722210,9923210
8202,2022-10-17,2,3,8202000,1722420,9924420
8203,2021-01-21,2,1,8203000,1722630,9925630
8204,2020-08-29,2,3,8204000,1722840,9926840
8205,2020-04-28,2,3,8205000,1723050,9928050
8206,2022-11-28,3,1,8206000,1723260,9929260
8207,2023-08-19,3,2,8207000,1723470,9930470
8208,2023-12-25,1,1,8208000,1723680,9931680
8209,2021-01-06,1,1,8209000,1723890,9932890
8210,2021-11-08,2,2,8210000,1724100,9934100
8211,2024-11-15,3,2,8211000,1724310,9935310
8212,2022-09-20,1,2,8212000,1724520,9936520
8213,2020-12-12,3,3,8213000,1724730,9937730
8214,2020-06-22,2,3,8214000,1724940,9938940
8215,2021-11-16,3,1,8215000,1725150,9940150
8216,2020-08-02,3,1,8216000,1725360,9941360
8217,2020-01-09,3,3,8217000,1725570,9942570
8218,2021-02-28,3,1,8218000,1725780,9943780
8219,2020-11-08,2,3,8219000,1725990,9944990
8220,2022-04-26,2,3,8220000,1726200,9946200
8221,2022-05-05,3,2,8221000,1726410,9947410
8222,2020-12-10,1,1,8222000,1726620,9948620
8223,2024-09-21,3,2,8223000,1726830,9949830
8224,2022-08-31,3,2,8224000,1727040,9951040
8225,2023-05-24,3,1,8225000,1727250,9952250
8226,2021-06-13,1,2,8226000,1727460,9953460
8227,2024-05-05,2,2,8227000,1727670,9954670
8228,2021-11-14,2,2,8228000,1727880,9955880
8229,2022-07-07,3,2,8229000,1728090,9957090
8230,2023-08-10,3,2,8230000,1728300,9958300
8231,2024-10-28,2,3,8231000,1728510,9959510
8232,2021-09-26,3,3,8232000,1728720,9960720
8233,2023-10-31,1,1,8233000,1728930,9961930
8234,2023-08-04,1,2,8234000,1729140,9963140
8235,2022-07-12,1,3,8235000,1729350,9964350
8236,2024-09-12,3,3,8236000,1729560,9965560
8237,2020-02-05,3,2,8237000,1729770,9966770
8238,2020-09-19,3,3,8238000,1729980,9967980
8239,2020-10-07,2,3,8239000,1730190,9969190
8240,2020-08-08,2,3,8240000,1730400,9970400
8241,2024-03-29,1,1,8241000,1730610,9971610
8242,2024-01-18,2,1,8242000,1730820,9972820
8243,2022-12-17,3,3,8243000,1731030,9974030
8244,2020-11-15,3,2,8244000,1731240,9975240
8245,2023-02-20,2,1,8245000,1731450,9976450
8246,2024-10-28,3,1,8246000,1731660,9977660
8247,2021-03-11,2,1,8247000,1731870,9978870
8248,2024-03-13,2,1,8248000,1732080,9980080
8249,2022-10-08,1,3,8249000,1732290,9981290
8250,2020-01-27,3,3,8250000,1732500,9982500
8251,2020-11-14,3,2,8251000,1732710,9983710
8252,2020-12-10,2,3,8252000,1732920,9984920
8253,2021-03-02,3,2,8253000,1733130,9986130
8254,2021-07-25,1,1,8254000,1733340,9987340
8255,2022-09-01,2,1,8255000,1733550,9988550
8256,2024-08-26,2,3,8256000,1733760,9989760
8257,2023-02-15,3,3,8257000,1733970,9990970
8258,2022-01-25,3,2,8258000,1734180,9992180
8259,2023-07-08,1,2,8259000,1734390,9993390
8260,2022-04-16,3,2,8260000,1734600,9994600
8261,2022-09-14,3,2,8261000,1734810,9995810
8262,2020-07-14,1,3,8262000,1735020,9997020
8263,2020-05-03,1,2,8263000,1735230,9998230
8264,2020-11-14,1,3,8264000,1735440,9999440
8265,2022-03-18,2,3,8265000,1735650,10000650
8266,2023-06-03,3,2,8266000,1735860,10001860
8267,2021-07-06,3,2,8267000,1736070,10003070
8268,2020-05-21,3,3,8268000,1736280,10004280
8269,2022-02-08,1,3,8269000,1736490,10005490
8270,2021-04-13,3,2,8270000,1736700,10006700
8271,2021-06-04,2,1,8271000,1736910,10007910
8272,2024-08-06,1,3,8272000,1737120,10009120
8273,2020-07-14,1,1,8273000,1737330,10010330
8274,2022-01-10,1,3,8274000,1737540,10011540
8275,2021-10-07,2,3,8275000,1737750,10012750
8276,2021-08-04,1,1,8276000,1737960,10013960
8277,2020-04-04,2,3,8277000,1738170,10015170
8278,2023-11-22,2,1,8278000,1738380,10016380
8279,2021-05-27,1,3,8279000,1738590,10017590
8280,2022-12-14,3,3,8280000,1738800,10018800
8281,2024-10-14,3,3,8281000,1739010,10020010
8282,2023-08-18,3,3,8282000,1739220,10021220
8283,2021-01-03,2,1,8283000,1739430,10022430
8284,2020-03-21,1,3,8284000,1739640,10023640
8285,2020-05-27,3,2,8285000,1739850,10024850
8286,2024-07-20,1,2,8286000,1740060,10026060
8287,2024-09-21,1,3,8287000,1740270,10027270
8288,2021-01-23,2,1,8288000,1740480,10028480
8289,2023-08-24,2,3,8289000,1740690,10029690
8290,2024-08-17,3,1,8290000,1740900,10030900
8291,2023-05-21,2,3,8291000,1741110,10032110
8292,2023-10-14,3,3,8292000,1741320,10033320
8293,2022-02-25,3,3,8293000,1741530,10034530
8294,2022-05-17,2,1,8294000,1741740,10035740
8295,2020-11-02,1,2,8295000,1741950,10036950
8296,2023-01-17,3,2,8296000,1742160,10038160
8297,2023-08-03,1,3,8297000,1742370,10039370
8298,2022-07-29,3,3,8298000,1742580,10040580
8299,2022-08-03,1,3,8299000,1742790,10041790
8300,2020-04-01,2,1,8300000,1743000,10043000
8301,2024-09-25,2,1,8301000,1743210,10044210
8302,2023-07-01,1,2,8302000,1743420,10045420
8303,2020-04-11,2,3,8303000,1743630,10046630
8304,2021-04-05,1,3,8304000,1743840,10047840
8305,2021-10-08,3,2,8305000,1744050,10049050
8306,2022-03-03,1,3,8306000,1744260,10050260
8307,2024-07-25,1,1,8307000,1744470,10051470
8308,2023-03-11,2,2,8308000,1744680,10052680
8309,2021-08-03,2,2,8309000,1744890,10053890
8310,2023-12-29,3,1,8310000,1745100,10055100
8311,2024-10-23,2,1,8311000,1745310,10056310
8312,2022-10-28,3,2,8312000,1745520,10057520
8313,2020-03-07,1,1,8313000,1745730,10058730
8314,2024-07-16,2,2,8314000,1745940,10059940
8315,2023-12-16,2,1,8315000,1746150,10061150
8316,2020-09-17,2,3,8316000,1746360,10062360
8317,2024-07-25,3,1,8317000,1746570,10063570
8318,2022-12-18,3,3,8318000,1746780,10064780
8319,2024-06-08,2,1,8319000,1746990,10065990
8320,2020-07-07,3,1,8320000,1747200,10067200
8321,2022-06-29,2,1,8321000,1747410,10068410
8322,2024-01-12,2,1,8322000,1747620,10069620
8323,2020-04-28,2,1,8323000,1747830,10070830
8324,2021-02-13,2,2,8324000,1748040,10072040
8325,2020-08-07,2,2,8325000,1748250,10073250
8326,2023-06-09,2,1,8326000,1748460,10074460
8327,2020-10-27,3,1,8327000,1748670,10075670
8328,2022-06-20,1,2,8328000,1748880,10076880
8329,2023-02-13,1,2,8329000,1749090,10078090
8330,2024-05-21,1,2,8330000,1749300,10079300
8331,2023-05-09,2,2,8331000,1749510,10080510
8332,2021-12-20,2,1,8332000,1749720,10081720
8333,2022-05-24,2,2,8333000,1749930,10082930
8334,2024-11-20,1,3,8334000,1750140,10084140
8335,2020-12-02,3,3,8335000,1750350,10085350
8336,2023-09-14,1,1,8336000,1750560,10086560
8337,2024-04-18,1,3,8337000,1750770,10087770
8338,2020-07-25,2,3,8338000,1750980,10088980
8339,2021-09-20,2,2,8339000,1751190,10090190
8340,2024-04-06,1,3,8340000,1751400,10091400
8341,2021-10-19,3,2,8341000,1751610,10092610
8342,2020-05-12,1,3,8342000,1751820,10093820
8343,2020-09-11,2,2,8343000,1752030,10095030
8344,2020-02-20,3,3,8344000,1752240,10096240
8345,2021-02-28,2,1,8345000,1752450,10097450
8346,2023-01-08,1,2,8346000,1752660,10098660
8347,2021-12-17,1,3,8347000,1752870,10099870
8348,2021-01-16,3,3,8348000,1753080,10101080
8349,2023-01-10,2,1,8349000,1753290,10102290
8350,2021-12-18,1,1,8350000,1753500,10103500
8351,2023-10-15,1,1,8351000,1753710,10104710
8352,2020-06-17,2,3,8352000,1753920,10105920
8353,2020-04-25,2,1,8353000,1754130,10107130
8354,2021-04-24,3,1,8354000,1754340,10108340
8355,2020-01-03,1,1,8355000,1754550,10109550
8356,2020-02-11,2,3,8356000,1754760,10110760
8357,2023-09-23,3,1,8357000,1754970,10111970
8358,2020-02-14,3,1,8358000,1755180,10113180
8359,2023-12-04,1,1,8359000,1755390,10114390
8360,2022-11-06,2,3,8360000,1755600,10115600
8361,2020-06-12,2,3,8361000,1755810,10116810
8362,2022-05-06,3,3,8362000,1756020,10118020
8363,2023-12-22,3,2,8363000,1756230,10119230
8364,2022-12-24,1,1,8364000,1756440,10120440
8365,2024-12-28,1,2,8365000,1756650,10121650
8366,2024-06-19,1,2,8366000,1756860,10122860
8367,2023-01-14,2,2,8367000,1757070,10124070
8368,2022-08-14,2,1,8368000,1757280,10125280
8369,2023-06-01,1,1,8369000,1757490,10126490
8370,2023-09-09,1,1,8370000,1757700,10127700
8371,2023-12-06,2,1,8371000,1757910,10128910
8372,2021-10-23,3,1,8372000,1758120,10130120
8373,2020-03-03,3,1,8373000,1758330,10131330
8374,2023-08-30,2,1,8374000,1758540,10132540
8375,2020-01-17,1,1,8375000,1758750,10133750
8376,2020-11-27,2,1,8376000,1758960,10134960
8377,2021-08-02,3,1,8377000,1759170,10136170
8378,2021-07-01,2,3,8378000,1759380,10137380
8379,2022-09-26,1,2,8379000,1759590,10138590
8380,2023-08-02,2,3,8380000,1759800,10139800
8381,2022-03-14,2,2,8381000,1760010,10141010
8382,2022-07-24,3,3,8382000,1760220,10142220
8383,2024-11-07,1,1,8383000,1760430,10143430
8384,2024-03-16,1,1,8384000,1760640,10144640
8385,2022-08-21,3,2,8385000,1760850,10145850
8386,2023-05-05,3,2,8386000,1761060,10147060
8387,2021-10-06,1,1,8387000,1761270,10148270
8388,2024-08-22,2,1,8388000,1761480,10149480
8389,2023-08-24,1,3,8389000,1761690,10150690
8390,2021-09-26,2,2,8390000,1761900,10151900
8391,2020-01-04,2,1,8391000,1762110,10153110
8392,2022-08-08,2,2,8392000,1762320,10154320
8393,2021-09-25,3,1,8393000,1762530,10155530
8394,2022-04-16,1,3,8394000,1762740,10156740
8395,2021-01-11,1,1,8395000,1762950,10157950
8396,2022-12-23,3,2,8396000,1763160,10159160
8397,2024-06-12,3,1,8397000,1763370,10160370
8398,2021-12-10,3,2,8398000,1763580,10161580
8399,2024-07-27,1,3,8399000,1763790,10162790
8400,2021-08-20,3,3,8400000,1764000,10164000
8401,2024-11-13,2,2,8401000,1764210,10165210
8402,2021-09-18,3,1,8402000,1764420,10166420
8403,2020-09-28,1,3,8403000,1764630,10167630
8404,2023-07-07,1,2,8404000,1764840,10168840
8405,2024-04-18,2,3,8405000,1765050,10170050
8406,2024-10-12,1,3,8406000,1765260,10171260
8407,2023-10-17,3,1,8407000,1765470,10172470
8408,2023-02-14,2,2,8408000,1765680,10173680
8409,2023-10-10,2,2,8409000,1765890,10174890
8410,2022-12-16,1,1,8410000,1766100,10176100
8411,2022-01-14,2,3,8411000,1766310,10177310
8412,2024-10-04,2,1,8412000,1766520,10178520
8413,2020-12-06,1,2,8413000,1766730,10179730
8414,2023-05-09,2,1,8414000,1766940,10180940
8415,2020-04-01,1,3,8415000,1767150,10182150
8416,2024-02-23,1,2,8416000,1767360,10183360
8417,2021-06-01,1,1,8417000,1767570,10184570
8418,2020-05-05,1,1,8418000,1767780,10185780
8419,2020-12-18,3,2,8419000,1767990,10186990
8420,2022-12-04,1,2,8420000,1768200,10188200
8421,2024-08-05,1,3,8421000,1768410,10189410
8422,2023-12-20,1,1,8422000,1768620,10190620
8423,2022-09-12,3,1,8423000,1768830,10191830
8424,2020-02-04,3,3,8424000,1769040,10193040
8425,2020-09-07,2,1,8425000,1769250,10194250
8426,2023-04-12,1,3,8426000,1769460,10195460
8427,2020-10-08,3,2,8427000,1769670,10196670
8428,2021-02-28,2,2,8428000,1769880,10197880
8429,2024-05-01,1,3,8429000,1770090,10199090
8430,2021-08-16,1,1,8430000,1770300,10200300
8431,2021-09-25,3,3,8431000,1770510,10201510
8432,2024-05-14,2,3,8432000,1770720,10202720
8433,2024-11-30,1,3,8433000,1770930,10203930
8434,2020-01-13,1,2,8434000,1771140,10205140
8435,2023-06-02,3,3,8435000,1771350,10206350
8436,2022-09-05,1,1,8436000,1771560,10207560
8437,2020-06-19,1,1,8437000,1771770,10208770
8438,2023-02-05,2,2,8438000,1771980,10209980
8439,2021-04-02,3,1,8439000,1772190,10211190
8440,2020-09-09,2,1,8440000,1772400,10212400
8441,2024-10-02,2,2,8441000,1772610,10213610
8442,2024-11-26,1,1,8442000,1772820,10214820
8443,2020-05-13,1,3,8443000,1773030,10216030
8444,2024-03-02,2,1,8444000,1773240,10217240
8445,2021-07-06,1,2,8445000,1773450,10218450
8446,2024-02-11,1,3,8446000,1773660,10219660
8447,2020-07-20,3,1,8447000,1773870,10220870
8448,2020-01-21,1,3,8448000,1774080,10222080
8449,2020-01-22,1,3,8449000,1774290,10223290
8450,2020-05-08,3,2,8450000,1774500,10224500
8451,2020-05-23,1,3,8451000,1774710,10225710
8452,2022-08-01,1,2,8452000,1774920,10226920
8453,2020-05-06,1,2,8453000,1775130,10228130
8454,2020-08-22,2,3,8454000,1775340,10229340
8455,2024-06-14,2,2,8455000,1775550,10230550
8456,2021-08-20,3,3,8456000,1775760,10231760
8457,2024-11-21,3,1,8457000,1775970,10232970
8458,2021-06-20,3,1,8458000,1776180,10234180
8459,2024-03-01,1,2,8459000,1776390,10235390
8460,2020-07-14,2,1,8460000,1776600,10236600
8461,2022-01-21,1,1,8461000,1776810,10237810
8462,2024-09-15,3,2,8462000,1777020,10239020
8463,2022-10-02,1,2,8463000,1777230,10240230
8464,2021-05-06,1,2,8464000,1777440,10241440
8465,2022-01-05,2,2,8465000,1777650,10242650
8466,2020-01-01,3,3,8466000,1777860,10243860
8467,2024-11-01,1,1,8467000,1778070,10245070
8468,2023-05-26,3,2,8468000,1778280,10246280
8469,2022-04-11,3,3,8469000,1778490,10247490
8470,2021-01-29,3,1,8470000,1778700,10248700
8471,2021-06-25,1,1,8471000,1778910,10249910
8472,2024-06-02,3,1,8472000,1779120,10251120
8473,2023-06-21,1,1,8473000,1779330,10252330
8474,2024-08-18,3,2,8474000,1779540,10253540
8475,2021-07-27,1,1,8475000,1779750,10254750
8476,2020-01-18,3,1,8476000,1779960,10255960
8477,2024-07-23,1,3,8477000,1780170,10257170
8478,2020-08-04,3,3,8478000,1780380,10258380
8479,2020-05-13,3,1,8479000,1780590,10259590
8480,2024-05-03,1,3,8480000,1780800,10260800
8481,2020-04-17,3,3,8481000,1781010,10262010
8482,2020-10-13,2,1,8482000,1781220,10263220
8483,2024-11-04,1,2,8483000,1781430,10264430
8484,2022-01-27,1,3,8484000,1781640,10265640
8485,2020-08-24,2,1,8485000,1781850,10266850
8486,2023-11-30,1,1,8486000,1782060,10268060
8487,2022-07-27,2,1,8487000,1782270,10269270
8488,2021-05-29,3,1,8488000,1782480,10270480
8489,2021-06-04,3,1,8489000,1782690,10271690
8490,2021-12-20,1,3,8490000,1782900,10272900
8491,2024-12-26,1,1,8491000,1783110,10274110
8492,2021-10-08,2,3,8492000,1783320,10275320
8493,2021-06-15,2,2,8493000,1783530,10276530
8494,2023-12-12,2,2,8494000,1783740,10277740
8495,2022-01-13,3,3,8495000,1783950,10278950
8496,2021-12-17,1,2,8496000,1784160,10280160
8497,2022-03-19,2,3,8497000,1784370,10281370
8498,2024-09-04,2,1,8498000,1784580,10282580
8499,2022-09-22,3,1,8499000,1784790,10283790
8500,2024-12-19,1,3,8500000,1785000,10285000
8501,2023-07-01,3,3,8501000,1785210,10286210
8502,2020-04-14,2,2,8502000,1785420,10287420
8503,2020-12-31,3,3,8503000,1785630,10288630
8504,2022-11-03,1,2,8504000,1785840,10289840
8505,2024-12-25,1,3,8505000,1786050,10291050
8506,2021-12-19,2,1,8506000,1786260,10292260
8507,2022-10-22,1,3,8507000,1786470,10293470
8508,2024-04-14,2,1,8508000,1786680,10294680
8509,2022-03-09,1,1,8509000,1786890,10295890
8510,2021-11-23,2,2,8510000,1787100,10297100
8511,2022-12-22,2,1,8511000,1787310,10298310
8512,2024-10-02,2,1,8512000,1787520,10299520
8513,2023-05-27,1,3,8513000,1787730,10300730
8514,2022-09-13,3,3,8514000,1787940,10301940
8515,2023-10-11,1,2,8515000,1788150,10303150
8516,2022-11-21,3,2,8516000,1788360,10304360
8517,2023-05-19,1,3,8517000,1788570,10305570
8518,2022-12-05,3,1,8518000,1788780,10306780
8519,2020-10-16,1,3,8519000,1788990,10307990
8520,2024-11-07,3,3,8520000,1789200,10309200
8521,2020-08-28,3,3,8521000,1789410,10310410
8522,2022-12-29,1,3,8522000,1789620,10311620
8523,2020-01-20,3,1,8523000,1789830,10312830
8524,2024-04-07,1,1,8524000,1790040,10314040
8525,2024-05-28,2,3,8525000,1790250,10315250
8526,2021-05-30,1,1,8526000,1790460,10316460
8527,2021-01-21,3,1,8527000,1790670,10317670
8528,2023-10-21,2,2,8528000,1790880,10318880
8529,2023-10-04,3,2,8529000,1791090,10320090
8530,2024-05-31,2,1,8530000,1791300,10321300
8531,2024-12-25,2,2,8531000,1791510,10322510
8532,2020-02-24,1,2,8532000,1791720,10323720
8533,2023-10-21,2,3,8533000,1791930,10324930
8534,2024-01-19,2,2,8534000,1792140,10326140
8535,2022-08-11,2,2,8535000,1792350,10327350
8536,2020-07-24,3,2,8536000,1792560,10328560
8537,2022-04-12,3,1,8537000,1792770,10329770
8538,2024-08-22,3,2,8538000,1792980,10330980
8539,2021-06-28,3,3,8539000,1793190,10332190
8540,2022-06-14,1,1,8540000,1793400,10333400
8541,2020-02-05,3,3,8541000,1793610,10334610
8542,2022-05-03,1,1,8542000,1793820,10335820
8543,2021-06-14,1,1,8543000,1794030,10337030
8544,2021-12-08,1,3,8544000,1794240,10338240
8545,2024-11-18,1,3,8545000,1794450,10339450
8546,2020-08-14,2,3,8546000,1794660,10340660
8547,2023-12-10,1,2,8547000,1794870,10341870
8548,2023-11-07,2,2,8548000,1795080,10343080
8549,2024-09-11,1,1,8549000,1795290,10344290
8550,2023-11-18,2,3,8550000,1795500,10345500
8551,2021-12-06,2,3,8551000,1795710,10346710
8552,2021-03-24,3,1,8552000,1795920,10347920
8553,2020-08-29,1,3,8553000,1796130,10349130
8554,2020-11-13,1,3,8554000,1796340,10350340
8555,2021-07-21,1,1,8555000,1796550,10351550
8556,2021-12-21,2,3,8556000,1796760,10352760
8557,2021-05-05,2,2,8557000,1796970,10353970
8558,2024-09-28,2,1,8558000,1797180,10355180
8559,2021-01-11,3,2,8559000,1797390,10356390
8560,2024-02-15,3,1,8560000,1797600,10357600
8561,2020-01-26,2,1,8561000,1797810,10358810
8562,2023-12-19,2,3,8562000,1798020,10360020
8563,2024-04-03,1,1,8563000,1798230,10361230
8564,2020-05-12,2,1,8564000,1798440,10362440
8565,2023-06-21,2,2,8565000,1798650,10363650
8566,2023-07-26,1,2,8566000,1798860,10364860
8567,2024-02-14,3,3,8567000,1799070,10366070
8568,2023-01-18,2,1,8568000,1799280,10367280
8569,2022-02-28,2,2,8569000,1799490,10368490
8570,2023-09-17,2,2,8570000,1799700,10369700
8571,2024-06-20,3,1,8571000,1799910,10370910
8572,2021-01-13,2,2,8572000,1800120,10372120
8573,2020-04-28,2,3,8573000,1800330,10373330
8574,2022-09-01,2,1,8574000,1800540,10374540
8575,2022-07-29,3,2,8575000,1800750,10375750
8576,2021-02-13,1,2,8576000,1800960,10376960
8577,2020-08-27,3,2,8577000,1801170,10378170
8578,2024-09-14,1,3,8578000,1801380,10379380
8579,2020-08-09,1,1,8579000,1801590,10380590
8580,2022-10-26,3,3,8580000,1801800,10381800
8581,2023-05-19,3,1,8581000,1802010,10383010
8582,2021-04-10,2,1,8582000,1802220,10384220
8583,2023-11-16,3,2,8583000,1802430,10385430
8584,2020-10-20,1,3,8584000,1802640,10386640
8585,2020-01-19,1,1,8585000,1802850,10387850
8586,2021-01-14,3,3,8586000,1803060,10389060
8587,2022-08-06,1,1,8587000,1803270,10390270
8588,2021-07-31,2,3,8588000,1803480,10391480
8589,2021-11-26,1,3,8589000,1803690,10392690
8590,2022-07-15,2,2,8590000,1803900,10393900
8591,2021-11-02,1,3,8591000,1804110,10395110
8592,2024-01-16,3,1,8592000,1804320,10396320
8593,2024-10-01,1,1,8593000,1804530,10397530
8594,2022-10-27,1,1,8594000,1804740,10398740
8595,2023-10-17,2,1,8595000,1804950,10399950
8596,2020-03-28,1,2,8596000,1805160,10401160
8597,2020-07-28,2,1,8597000,1805370,10402370
8598,2021-05-07,1,3,8598000,1805580,10403580
8599,2022-04-08,3,2,8599000,1805790,10404790
8600,2020-01-24,3,3,8600000,1806000,10406000
8601,2021-10-19,3,1,8601000,1806210,10407210
8602,2023-06-07,1,3,8602000,1806420,10408420
8603,2024-01-06,3,1,8603000,1806630,10409630
8604,2024-01-14,2,3,8604000,1806840,10410840
8605,2024-06-22,1,3,8605000,1807050,10412050
8606,2024-03-07,2,3,8606000,1807260,10413260
8607,2021-10-20,2,1,8607000,1807470,10414470
8608,2020-12-20,3,2,8608000,1807680,10415680
8609,2022-06-04,2,1,8609000,1807890,10416890
8610,2024-11-17,3,1,8610000,1808100,10418100
8611,2024-11-21,1,1,8611000,1808310,10419310
8612,2023-03-28,2,2,8612000,1808520,10420520
8613,2024-05-30,2,2,8613000,1808730,10421730
8614,2023-06-26,3,1,8614000,1808940,10422940
8615,2024-02-23,3,3,8615000,1809150,10424150
8616,2021-01-22,3,1,8616000,1809360,10425360
8617,2024-06-23,1,3,8617000,1809570,10426570
8618,2024-06-19,1,2,8618000,1809780,10427780
8619,2020-04-18,2,1,8619000,1809990,10428990
8620,2022-09-03,2,2,8620000,1810200,10430200
8621,2024-04-06,3,1,8621000,1810410,10431410
8622,2022-11-18,1,3,8622000,1810620,10432620
8623,2021-07-29,2,3,8623000,1810830,10433830
8624,2023-12-16,1,2,8624000,1811040,10435040
8625,2020-12-14,1,2,8625000,1811250,10436250
8626,2021-10-16,3,2,8626000,1811460,10437460
8627,2020-06-13,3,1,8627000,1811670,10438670
8628,2024-08-25,3,1,8628000,1811880,10439880
8629,2022-08-27,1,3,8629000,1812090,10441090
8630,2021-05-26,3,2,8630000,1812300,10442300
8631,2021-03-10,1,1,8631000,1812510,10443510
8632,2022-08-07,3,2,8632000,1812720,10444720
8633,2023-04-16,3,1,8633000,1812930,10445930
8634,2023-02-07,3,2,8634000,1813140,10447140
8635,2021-09-18,2,3,8635000,1813350,10448350
8636,2023-08-21,1,2,8636000,1813560,10449560
8637,2020-04-20,1,1,8637000,1813770,10450770
8638,2021-11-12,3,3,8638000,1813980,10451980
8639,2020-09-15,2,2,8639000,1814190,10453190
8640,2020-05-09,1,1,8640000,1814400,10454400
8641,2020-08-14,1,2,8641000,1814610,10455610
8642,2021-08-25,1,3,8642000,1814820,10456820
8643,2021-02-25,1,1,8643000,1815030,10458030
8644,2023-03-03,3,3,8644000,1815240,10459240
8645,2020-07-08,3,2,8645000,1815450,10460450
8646,2023-01-16,1,3,8646000,1815660,10461660
8647,2020-06-12,2,1,8647000,1815870,10462870
8648,2024-12-25,3,3,8648000,1816080,10464080
8649,2022-06-15,3,3,8649000,1816290,10465290
8650,2022-06-03,1,2,8650000,1816500,10466500
8651,2020-05-28,1,3,8651000,1816710,10467710
8652,2021-11-15,1,1,8652000,1816920,10468920
8653,2024-04-06,1,3,8653000,1817130,10470130
8654,2020-04-08,1,2,8654000,1817340,10471340
8655,2023-12-01,3,3,8655000,1817550,10472550
8656,2023-11-03,2,1,8656000,1817760,10473760
8657,2022-06-26,1,2,8657000,1817970,10474970
8658,2020-10-16,1,1,8658000,1818180,10476180
8659,2020-11-11,3,1,8659000,1818390,10477390
8660,2022-04-27,2,2,8660000,1818600,10478600
8661,2022-06-09,3,1,8661000,1818810,10479810
8662,2021-09-23,2,2,8662000,1819020,10481020
8663,2020-07-06,3,1,8663000,1819230,10482230
8664,2020-07-29,3,2,8664000,1819440,10483440
8665,2020-10-23,2,2,8665000,1819650,10484650
8666,2022-01-05,1,1,8666000,1819860,10485860
8667,2024-08-02,3,2,8667000,1820070,10487070
8668,2023-07-02,2,2,8668000,1820280,10488280
8669,2020-02-10,3,1,8669000,1820490,10489490
8670,2022-02-04,3,3,8670000,1820700,10490700
8671,2021-01-10,1,1,8671000,1820910,10491910
8672,2023-11-12,1,2,8672000,1821120,10493120
8673,2024-08-25,3,3,8673000,1821330,10494330
8674,2021-02-09,3,2,8674000,1821540,10495540
8675,2023-05-09,1,2,8675000,1821750,10496750
8676,2021-07-17,2,2,8676000,1821960,10497960
8677,2021-03-03,1,3,8677000,1822170,10499170
8678,2022-02-07,3,2,8678000,1822380,10500380
8679,2021-07-29,1,1,8679000,1822590,10501590
8680,2020-04-10,2,1,8680000,1822800,10502800
8681,2022-05-07,2,2,8681000,1823010,10504010
8682,2022-07-20,2,2,8682000,1823220,10505220
8683,2023-03-04,3,3,8683000,1823430,10506430
8684,2021-03-15,2,3,8684000,1823640,10507640
8685,2022-08-09,3,3,8685000,1823850,10508850
8686,2022-07-20,2,3,8686000,1824060,10510060
8687,2023-04-08,1,3,8687000,1824270,10511270
8688,2020-05-29,3,3,8688000,1824480,10512480
8689,2023-04-28,3,3,8689000,1824690,10513690
8690,2024-07-30,3,3,8690000,1824900,10514900
8691,2020-09-12,3,3,8691000,1825110,10516110
8692,2023-06-19,2,3,8692000,1825320,10517320
8693,2021-07-29,3,3,8693000,1825530,10518530
8694,2021-04-07,1,2,8694000,1825740,10519740
8695,2024-08-13,1,3,8695000,1825950,10520950
8696,2022-10-05,2,3,8696000,1826160,10522160
8697,2023-08-29,1,3,8697000,1826370,10523370
8698,2020-10-30,3,2,8698000,1826580,10524580
8699,2020-12-24,2,1,8699000,1826790,10525790
8700,2020-07-22,3,3,8700000,1827000,10527000
8701,2024-07-02,3,3,8701000,1827210,10528210
8702,2020-02-19,3,1,8702000,1827420,10529420
8703,2021-01-11,2,1,8703000,1827630,10530630
8704,2020-04-10,3,3,8704000,1827840,10531840
8705,2024-10-18,2,1,8705000,1828050,10533050
8706,2021-10-17,3,2,8706000,1828260,10534260
8707,2020-10-09,1,3,8707000,1828470,10535470
8708,2020-02-04,3,2,8708000,1828680,10536680
8709,2020-09-12,3,1,8709000,1828890,10537890
8710,2024-04-17,1,2,8710000,1829100,10539100
8711,2022-07-08,3,3,8711000,1829310,10540310
8712,2023-11-29,1,3,8712000,1829520,10541520
8713,2022-01-14,3,3,8713000,1829730,10542730
8714,2023-03-03,3,2,8714000,1829940,10543940
8715,2022-08-04,2,2,8715000,1830150,10545150
8716,2020-02-14,1,3,8716000,1830360,10546360
8717,2023-12-23,1,2,8717000,1830570,10547570
8718,2022-01-21,3,3,8718000,1830780,10548780
8719,2022-09-26,2,1,8719000,1830990,10549990
8720,2021-11-24,3,1,8720000,1831200,10551200
8721,2020-12-25,2,1,8721000,1831410,10552410
8722,2021-01-04,1,1,8722000,1831620,10553620
8723,2020-06-26,3,2,8723000,1831830,10554830
8724,2024-03-01,1,3,8724000,1832040,10556040
8725,2022-08-18,3,2,8725000,1832250,10557250
8726,2023-03-06,1,1,8726000,1832460,10558460
8727,2021-07-20,3,2,8727000,1832670,10559670
8728,2023-08-31,3,3,8728000,1832880,10560880
8729,2023-05-04,1,2,8729000,1833090,10562090
8730,2022-05-16,2,2,8730000,1833300,10563300
8731,2024-12-02,3,3,8731000,1833510,10564510
8732,2020-01-18,3,3,8732000,1833720,10565720
8733,2022-06-18,1,2,8733000,1833930,10566930
8734,2020-10-28,3,1,8734000,1834140,10568140
8735,2020-06-18,1,3,8735000,1834350,10569350
8736,2020-07-24,1,3,8736000,1834560,10570560
8737,2020-08-19,3,1,8737000,1834770,10571770
8738,2022-08-02,1,1,8738000,1834980,10572980
8739,2022-05-25,2,2,8739000,1835190,10574190
8740,2024-06-25,2,1,8740000,1835400,10575400
8741,2022-10-17,3,2,8741000,1835610,10576610
8742,2020-03-15,3,2,8742000,1835820,10577820
8743,2021-10-28,1,1,8743000,1836030,10579030
8744,2024-01-11,1,1,8744000,1836240,10580240
8745,2021-04-08,2,3,8745000,1836450,10581450
8746,2020-11-17,1,3,8746000,1836660,10582660
8747,2020-11-21,2,1,8747000,1836870,10583870
8748,2023-10-22,2,2,8748000,1837080,10585080
8749,2021-10-24,1,2,8749000,1837290,10586290
8750,2021-05-25,1,3,8750000,1837500,10587500
8751,2024-10-23,3,2,8751000,1837710,10588710
8752,2021-12-28,2,3,8752000,1837920,10589920
8753,2021-05-17,2,1,8753000,1838130,10591130
8754,2023-02-07,1,3,8754000,1838340,10592340
8755,2020-10-13,2,2,8755000,1838550,10593550
8756,2020-03-19,2,3,8756000,1838760,10594760
8757,2024-10-25,3,1,8757000,1838970,10595970
8758,2022-05-06,2,3,8758000,1839180,10597180
8759,2022-06-02,1,2,8759000,1839390,10598390
8760,2022-12-27,2,1,8760000,1839600,10599600
8761,2020-06-24,1,2,8761000,1839810,10600810
8762,2022-08-20,3,3,8762000,1840020,10602020
8763,2021-03-25,1,2,8763000,1840230,10603230
8764,2023-02-11,1,1,8764000,1840440,10604440
8765,2024-10-14,1,2,8765000,1840650,10605650
8766,2022-07-07,3,2,8766000,1840860,10606860
8767,2022-04-15,2,3,8767000,1841070,10608070
8768,2024-09-22,3,3,8768000,1841280,10609280
8769,2022-11-15,1,1,8769000,1841490,10610490
8770,2021-10-09,1,2,8770000,1841700,10611700
8771,2021-05-31,3,3,8771000,1841910,10612910
8772,2022-06-27,2,1,8772000,1842120,10614120
8773,2024-11-02,1,1,8773000,1842330,10615330
8774,2024-12-04,3,3,8774000,1842540,10616540
8775,2023-03-26,1,1,8775000,1842750,10617750
8776,2023-05-21,2,2,8776000,1842960,10618960
8777,2022-11-14,2,2,8777000,1843170,10620170
8778,2021-02-16,1,3,8778000,1843380,10621380
8779,2020-05-20,2,2,8779000,1843590,10622590
8780,2021-06-11,2,1,8780000,1843800,10623800
8781,2024-06-30,2,1,8781000,1844010,10625010
8782,2021-11-04,2,3,8782000,1844220,10626220
8783,2021-06-30,2,3,8783000,1844430,10627430
8784,2022-12-25,2,1,8784000,1844640,10628640
8785,2023-11-14,2,1,8785000,1844850,10629850
8786,2020-09-16,1,1,8786000,1845060,10631060
8787,2020-10-07,2,3,8787000,1845270,10632270
8788,2020-09-30,2,2,8788000,1845480,10633480
8789,2022-08-16,1,1,8789000,1845690,10634690
8790,2021-09-07,3,1,8790000,1845900,10635900
8791,2023-06-02,3,2,8791000,1846110,10637110
8792,2022-05-08,2,2,8792000,1846320,10638320
8793,2022-02-14,3,2,8793000,1846530,10639530
8794,2021-02-14,1,2,8794000,1846740,10640740
8795,2024-07-13,2,1,8795000,1846950,10641950
8796,2021-04-09,1,1,8796000,1847160,10643160
8797,2024-10-15,1,3,8797000,1847370,10644370
8798,2021-08-07,3,1,8798000,1847580,10645580
8799,2022-04-15,1,2,8799000,1847790,10646790
8800,2024-06-09,2,2,8800000,1848000,10648000
8801,2023-10-28,1,2,8801000,1848210,10649210
8802,2024-08-24,3,1,8802000,1848420,10650420
8803,2023-09-15,2,2,8803000,1848630,10651630
8804,2024-08-29,1,2,8804000,1848840,10652840
8805,2021-10-13,1,3,8805000,1849050,10654050
8806,2024-04-25,3,1,8806000,1849260,10655260
8807,2024-09-18,3,1,8807000,1849470,10656470
8808,2023-08-02,3,1,8808000,1849680,10657680
8809,2022-06-16,2,3,8809000,1849890,10658890
8810,2023-08-13,2,2,8810000,1850100,10660100
8811,2023-06-18,3,2,8811000,1850310,10661310
8812,2024-09-27,3,1,8812000,1850520,10662520
8813,2023-03-07,2,2,8813000,1850730,10663730
8814,2021-04-07,3,3,8814000,1850940,10664940
8815,2021-10-30,1,2,8815000,1851150,10666150
8816,2023-04-13,1,3,8816000,1851360,10667360
8817,2023-08-14,3,3,8817000,1851570,10668570
8818,2022-01-11,2,1,8818000,1851780,10669780
8819,2024-04-16,2,3,8819000,1851990,10670990
8820,2020-10-29,2,1,8820000,1852200,10672200
8821,2024-03-28,2,1,8821000,1852410,10673410
8822,2022-11-25,1,2,8822000,1852620,10674620
8823,2024-09-23,3,3,8823000,1852830,10675830
8824,2023-02-07,3,3,8824000,1853040,10677040
8825,2022-09-25,1,1,8825000,1853250,10678250
8826,2024-04-02,2,1,8826000,1853460,10679460
8827,2023-07-18,3,3,8827000,1853670,10680670
8828,2021-06-01,3,3,8828000,1853880,10681880
8829,2020-12-12,1,3,8829000,1854090,10683090
8830,2020-01-29,1,3,8830000,1854300,10684300
8831,2022-01-16,3,3,8831000,1854510,10685510
8832,2022-06-10,3,3,8832000,1854720,10686720
8833,2022-12-16,2,3,8833000,1854930,10687930
8834,2023-05-23,3,2,8834000,1855140,10689140
8835,2022-10-26,2,3,8835000,1855350,10690350
8836,2020-02-10,3,3,8836000,1855560,10691560
8837,2023-09-29,2,3,8837000,1855770,10692770
8838,2021-02-11,1,2,8838000,1855980,10693980
8839,2024-06-22,2,3,8839000,1856190,10695190
8840,2020-12-22,1,2,8840000,1856400,10696400
8841,2023-10-21,3,2,8841000,1856610,10697610
8842,2024-03-28,3,2,8842000,1856820,10698820
8843,2024-01-16,2,3,8843000,1857030,10700030
8844,2021-11-30,2,1,8844000,1857240,10701240
8845,2021-04-02,3,1,8845000,1857450,10702450
8846,2022-06-01,1,2,8846000,1857660,10703660
8847,2021-03-13,3,1,8847000,1857870,10704870
8848,2021-06-10,2,3,8848000,1858080,10706080
8849,2023-10-14,2,2,8849000,1858290,10707290
8850,2023-01-08,1,3,8850000,1858500,10708500
8851,2022-09-05,1,3,8851000,1858710,10709710
8852,2020-03-12,2,1,8852000,1858920,10710920
8853,2021-11-17,1,1,8853000,1859130,10712130
8854,2023-02-25,1,2,8854000,1859340,10713340
8855,2020-05-06,1,1,8855000,1859550,10714550
8856,2021-12-25,1,1,8856000,1859760,10715760
8857,2024-05-09,2,3,8857000,1859970,10716970
8858,2023-08-30,3,3,8858000,1860180,10718180
8859,2020-02-08,3,3,8859000,1860390,10719390
8860,2022-08-22,1,3,8860000,1860600,10720600
8861,2020-07-30,3,1,8861000,1860810,10721810
8862,2022-11-14,3,1,8862000,1861020,10723020
8863,2022-02-18,3,1,8863000,1861230,10724230
8864,2022-03-31,2,3,8864000,1861440,10725440
8865,2024-11-14,1,2,8865000,1861650,10726650
8866,2020-01-30,2,2,8866000,1861860,10727860
8867,2020-07-12,1,1,8867000,1862070,10729070
8868,2024-11-13,1,2,8868000,1862280,10730280
8869,2023-07-02,3,2,8869000,1862490,10731490
8870,2022-11-13,3,1,8870000,1862700,10732700
8871,2024-01-19,2,3,8871000,1862910,10733910
8872,2024-01-08,3,1,8872000,1863120,10735120
8873,2022-03-08,1,3,8873000,1863330,10736330
8874,2021-09-16,1,1,8874000,1863540,10737540
8875,2024-06-12,2,2,8875000,1863750,10738750
8876,2023-01-05,1,3,8876000,1863960,10739960
8877,2022-02-07,1,2,8877000,1864170,10741170
8878,2020-09-04,1,3,8878000,1864380,10742380
8879,2020-02-29,3,2,8879000,1864590,10743590
8880,2021-08-10,1,2,8880000,1864800,10744800
8881,2023-12-23,2,3,8881000,1865010,10746010
8882,2022-09-02,3,3,8882000,1865220,10747220
8883,2022-12-06,1,2,8883000,1865430,10748430
8884,2024-09-03,3,3,8884000,1865640,10749640
8885,2021-10-28,1,1,8885000,1865850,10750850
8886,2020-07-01,2,3,8886000,1866060,10752060
8887,2024-01-02,3,2,8887000,1866270,10753270
8888,2020-10-27,2,1,8888000,1866480,10754480
8889,2023-08-22,2,1,8889000,1866690,10755690
8890,2022-08-05,1,2,8890000,1866900,10756900
8891,2024-05-19,3,2,8891000,1867110,10758110
8892,2022-10-10,1,3,8892000,1867320,10759320
8893,2022-11-25,3,1,8893000,1867530,10760530
8894,2022-02-04,3,3,8894000,1867740,10761740
8895,2023-07-17,2,3,8895000,1867950,10762950
8896,2023-05-16,3,3,8896000,1868160,10764160
8897,2023-07-28,2,1,8897000,1868370,10765370
8898,2021-07-07,2,3,8898000,1868580,10766580
8899,2023-10-12,2,3,8899000,1868790,10767790
8900,2021-10-25,2,3,8900000,1869000,10769000
8901,2024-03-13,3,2,8901000,1869210,10770210
8902,2020-03-11,1,2,8902000,1869420,10771420
8903,2023-04-05,2,2,8903000,1869630,10772630
8904,2022-07-13,2,1,8904000,1869840,10773840
8905,2020-01-21,1,1,8905000,1870050,10775050
8906,2023-04-24,3,1,8906000,1870260,10776260
8907,2023-03-27,3,3,8907000,1870470,10777470
8908,2024-01-30,3,3,8908000,1870680,10778680
8909,2020-07-21,2,3,8909000,1870890,10779890
8910,2022-12-28,1,3,8910000,1871100,10781100
8911,2024-10-20,3,1,8911000,1871310,10782310
8912,2022-06-17,1,1,8912000,1871520,10783520
8913,2022-05-26,1,2,8913000,1871730,10784730
8914,2020-09-08,1,3,8914000,1871940,10785940
8915,2022-10-06,3,3,8915000,1872150,10787150
8916,2021-07-10,1,1,8916000,1872360,10788360
8917,2021-03-22,2,1,8917000,1872570,10789570
8918,2020-01-30,2,1,8918000,1872780,10790780
8919,2021-07-20,1,2,8919000,1872990,10791990
8920,2023-12-04,3,2,8920000,1873200,10793200
8921,2022-11-19,3,3,8921000,1873410,10794410
8922,2020-10-12,3,3,8922000,1873620,10795620
8923,2024-01-19,3,2,8923000,1873830,10796830
8924,2021-11-15,1,1,8924000,1874040,10798040
8925,2023-12-29,1,3,8925000,1874250,10799250
8926,2023-08-21,1,3,8926000,1874460,10800460
8927,2024-12-10,2,1,8927000,1874670,10801670
8928,2021-01-10,3,1,8928000,1874880,10802880
8929,2023-02-06,2,2,8929000,1875090,10804090
8930,2022-08-24,3,2,8930000,1875300,10805300
8931,2020-10-06,2,3,8931000,1875510,10806510
8932,2023-02-10,2,2,8932000,1875720,10807720
8933,2021-06-27,1,3,8933000,1875930,10808930
8934,2023-08-05,1,3,8934000,1876140,10810140
8935,2021-11-10,3,3,8935000,1876350,10811350
8936,2021-10-01,1,2,8936000,1876560,10812560
8937,2022-09-12,3,2,8937000,1876770,10813770
8938,2021-01-08,2,1,8938000,1876980,10814980
8939,2023-09-29,3,2,8939000,1877190,10816190
8940,2020-03-02,2,3,8940000,1877400,10817400
8941,2022-01-22,2,1,8941000,1877610,10818610
8942,2023-01-29,2,2,8942000,1877820,10819820
8943,2024-10-03,3,1,8943000,1878030,10821030
8944,2023-10-30,1,2,8944000,1878240,10822240
8945,2020-03-12,1,2,8945000,1878450,10823450
8946,2020-07-07,1,3,8946000,1878660,10824660
8947,2023-07-15,3,3,8947000,1878870,10825870
8948,2022-06-09,2,1,8948000,1879080,10827080
8949,2023-03-27,1,1,8949000,1879290,10828290
8950,2023-11-25,3,3,8950000,1879500,10829500
8951,2020-06-02,1,2,8951000,1879710,10830710
8952,2020-10-12,2,3,8952000,1879920,10831920
8953,2022-10-06,1,2,8953000,1880130,10833130
8954,2023-08-20,2,2,8954000,1880340,10834340
8955,2024-08-13,1,1,8955000,1880550,10835550
8956,2020-09-01,1,2,8956000,1880760,10836760
8957,2022-10-09,3,3,8957000,1880970,10837970
8958,2023-09-30,3,3,8958000,1881180,10839180
8959,2024-12-15,3,2,8959000,1881390,10840390
8960,2023-02-24,3,2,8960000,1881600,10841600
8961,2022-08-15,1,2,8961000,1881810,10842810
8962,2020-10-24,1,2,8962000,1882020,10844020
8963,2020-01-07,2,3,8963000,1882230,10845230
8964,2022-07-28,2,3,8964000,1882440,10846440
8965,2020-06-07,3,2,8965000,1882650,10847650
8966,2024-09-16,1,3,8966000,1882860,10848860
8967,2023-12-23,2,3,8967000,1883070,10850070
8968,2023-10-15,2,2,8968000,1883280,10851280
8969,2022-01-25,1,2,8969000,1883490,10852490
8970,2022-08-14,2,2,8970000,1883700,10853700
8971,2023-03-31,1,2,8971000,1883910,10854910
8972,2023-04-08,3,1,8972000,1884120,10856120
8973,2020-10-25,2,1,8973000,1884330,10857330
8974,2022-03-18,3,2,8974000,1884540,10858540
8975,2021-09-22,1,2,8975000,1884750,10859750
8976,2022-08-28,1,1,8976000,1884960,10860960
8977,2020-05-17,2,2,8977000,1885170,10862170
8978,2020-05-31,1,3,8978000,1885380,10863380
8979,2022-09-20,1,3,8979000,1885590,10864590
8980,2021-07-31,3,2,8980000,1885800,10865800
8981,2021-02-12,2,1,8981000,1886010,10867010
8982,2023-01-14,3,3,8982000,1886220,10868220
8983,2021-11-01,2,1,8983000,1886430,10869430
8984,2022-06-30,1,1,8984000,1886640,10870640
8985,2023-01-17,2,1,8985000,1886850,10871850
8986,2022-10-10,1,3,8986000,1887060,10873060
8987,2022-01-19,1,1,8987000,1887270,10874270
8988,2022-06-09,1,1,8988000,1887480,10875480
8989,2021-11-27,3,1,8989000,1887690,10876690
8990,2022-03-27,1,1,8990000,1887900,10877900
8991,2021-08-08,1,3,8991000,1888110,10879110
8992,2021-02-28,3,1,8992000,1888320,10880320
8993,2023-10-30,2,1,8993000,1888530,10881530
8994,2021-01-27,3,3,8994000,1888740,10882740
8995,2023-08-16,2,3,8995000,1888950,10883950
8996,2024-04-10,2,2,8996000,1889160,10885160
8997,2023-03-24,1,1,8997000,1889370,10886370
8998,2024-08-13,2,3,8998000,1889580,10887580
8999,2022-07-20,3,2,8999000,1889790,10888790
9000,2023-09-12,1,3,9000000,1890000,10890000
9001,2023-04-11,3,1,9001000,1890210,10891210
9002,2024-05-27,1,1,9002000,1890420,10892420
9003,2020-10-28,3,2,9003000,1890630,10893630
9004,2023-01-30,1,3,9004000,1890840,10894840
9005,2024-08-03,3,3,9005000,1891050,10896050
9006,2024-10-21,2,3,9006000,1891260,10897260
9007,2022-03-02,3,1,9007000,1891470,10898470
9008,2020-08-24,3,3,9008000,1891680,10899680
9009,2024-07-30,1,1,9009000,1891890,10900890
9010,2023-02-01,2,1,9010000,1892100,10902100
9011,2024-07-02,2,3,9011000,1892310,10903310
9012,2020-12-20,1,1,9012000,1892520,10904520
9013,2022-01-08,3,1,9013000,1892730,10905730
9014,2024-01-09,3,2,9014000,1892940,10906940
9015,2024-02-01,3,1,9015000,1893150,10908150
9016,2024-01-14,1,3,9016000,1893360,10909360
9017,2023-02-27,3,2,9017000,1893570,10910570
9018,2021-04-07,2,2,9018000,1893780,10911780
9019,2020-08-28,3,3,9019000,1893990,10912990
9020,2021-12-28,2,3,9020000,1894200,10914200
9021,2023-03-07,2,1,9021000,1894410,10915410
9022,2024-07-24,1,2,9022000,1894620,10916620
9023,2023-12-11,2,2,9023000,1894830,10917830
9024,2024-06-19,1,2,9024000,1895040,10919040
9025,2020-08-11,3,3,9025000,1895250,10920250
9026,2024-12-10,1,2,9026000,1895460,10921460
9027,2021-12-31,2,2,9027000,1895670,10922670
9028,2024-04-22,2,1,9028000,1895880,10923880
9029,2021-03-24,2,3,9029000,1896090,10925090
9030,2023-08-30,2,2,9030000,1896300,10926300
9031,2021-10-06,1,3,9031000,1896510,10927510
9032,2020-01-27,1,1,9032000,1896720,10928720
9033,2023-09-16,3,3,9033000,1896930,10929930
9034,2023-06-07,2,3,9034000,1897140,10931140
9035,2022-01-30,3,1,9035000,1897350,10932350
9036,2022-08-02,3,3,9036000,1897560,10933560
9037,2020-03-07,1,3,9037000,1897770,10934770
9038,2024-08-25,1,1,9038000,1897980,10935980
9039,2021-05-12,1,2,9039000,1898190,10937190
9040,2023-11-09,3,1,9040000,1898400,10938400
9041,2022-04-26,3,3,9041000,1898610,10939610
9042,2023-03-29,3,2,9042000,1898820,10940820
9043,2022-01-07,2,1,9043000,1899030,10942030
9044,2020-04-08,2,2,9044000,1899240,10943240
9045,2022-05-29,1,3,9045000,1899450,10944450
9046,2024-01-06,3,2,9046000,1899660,10945660
9047,2022-03-08,3,2,9047000,1899870,10946870
9048,2023-07-25,1,1,9048000,1900080,10948080
9049,2023-09-03,3,1,9049000,1900290,10949290
9050,2024-01-07,2,2,9050000,1900500,10950500
9051,2020-06-10,2,3,9051000,1900710,10951710
9052,2021-08-19,1,3,9052000,1900920,10952920
9053,2020-05-17,2,1,9053000,1901130,10954130
9054,2021-07-24,2,2,9054000,1901340,10955340
9055,2023-07-18,2,3,9055000,1901550,10956550
9056,2023-12-27,1,3,9056000,1901760,10957760
9057,2022-07-26,2,1,9057000,1901970,10958970
9058,2020-12-24,2,2,9058000,1902180,10960180
9059,2021-11-20,1,3,9059000,1902390,10961390
9060,2024-04-23,1,3,9060000,1902600,10962600
9061,2024-01-23,2,3,9061000,1902810,10963810
9062,2022-03-22,1,2,9062000,1903020,10965020
9063,2021-06-23,1,2,9063000,1903230,10966230
9064,2021-04-25,2,3,9064000,1903440,10967440
9065,2022-08-10,3,2,9065000,1903650,10968650
9066,2021-09-01,2,1,9066000,1903860,10969860
9067,2021-03-08,3,1,9067000,1904070,10971070
9068,2023-07-10,1,3,9068000,1904280,10972280
9069,2023-06-24,1,1,9069000,1904490,10973490
9070,2022-08-17,1,3,9070000,1904700,10974700
9071,2022-03-31,1,2,9071000,1904910,10975910
9072,2024-11-07,1,2,9072000,1905120,10977120
9073,2023-12-29,3,1,9073000,1905330,10978330
9074,2024-05-29,1,2,9074000,1905540,10979540
9075,2020-10-18,2,2,9075000,1905750,10980750
9076,2020-05-01,3,1,9076000,1905960,10981960
9077,2022-06-11,2,1,9077000,1906170,10983170
9078,2024-05-07,2,3,9078000,1906380,10984380
9079,2021-01-15,1,2,9079000,1906590,10985590
9080,2024-03-23,3,2,9080000,1906800,10986800
9081,2024-06-25,2,2,9081000,1907010,10988010
9082,2022-07-23,2,3,9082000,1907220,10989220
9083,2020-03-30,3,1,9083000,1907430,10990430
9084,2021-03-24,1,2,9084000,1907640,10991640
9085,2023-07-26,3,3,9085000,1907850,10992850
9086,2023-06-30,1,3,9086000,1908060,10994060
9087,2024-02-23,3,1,9087000,1908270,10995270
9088,2023-05-21,1,1,9088000,1908480,10996480
9089,2023-12-14,3,1,9089000,1908690,10997690
9090,2024-09-04,2,1,9090000,1908900,10998900
9091,2024-04-30,2,2,9091000,1909110,11000110
9092,2024-06-16,3,1,9092000,1909320,11001320
9093,2023-06-24,2,3,9093000,1909530,11002530
9094,2022-06-22,3,2,9094000,1909740,11003740
9095,2023-09-07,3,1,9095000,1909950,11004950
9096,2024-12-24,3,2,9096000,1910160,11006160
9097,2024-05-07,1,3,9097000,1910370,11007370
9098,2020-05-31,2,1,9098000,1910580,11008580
9099,2021-03-30,3,3,9099000,1910790,11009790
9100,2022-08-11,3,1,9100000,1911000,11011000
9101,2022-01-16,2,3,9101000,1911210,11012210
9102,2021-07-10,2,3,9102000,1911420,11013420
9103,2021-02-18,2,1,9103000,1911630,11014630
9104,2024-12-23,3,3,9104000,1911840,11015840
9105,2021-11-03,2,3,9105000,1912050,11017050
9106,2023-06-01,1,2,9106000,1912260,11018260
9107,2023-05-19,2,2,9107000,1912470,11019470
9108,2024-08-20,2,2,9108000,1912680,11020680
9109,2024-02-25,1,1,9109000,1912890,11021890
9110,2022-06-11,2,2,9110000,1913100,11023100
9111,2023-10-02,3,1,9111000,1913310,11024310
9112,2022-01-22,1,2,9112000,1913520,11025520
9113,2022-10-11,1,3,9113000,1913730,11026730
9114,2021-09-20,3,3,9114000,1913940,11027940
9115,2024-09-09,1,2,9115000,1914150,11029150
9116,2024-10-19,3,3,9116000,1914360,11030360
9117,2024-10-19,3,3,9117000,1914570,11031570
9118,2021-11-17,3,1,9118000,1914780,11032780
9119,2020-07-14,1,2,9119000,1914990,11033990
9120,2022-04-24,1,3,9120000,1915200,11035200
9121,2023-11-28,3,3,9121000,1915410,11036410
9122,2022-05-06,3,2,9122000,1915620,11037620
9123,2020-07-04,3,2,9123000,1915830,11038830
9124,2021-07-26,2,1,9124000,1916040,11040040
9125,2020-09-26,1,2,9125000,1916250,11041250
9126,2023-11-27,2,3,9126000,1916460,11042460
9127,2022-05-25,3,2,9127000,1916670,11043670
9128,2023-02-28,1,3,9128000,1916880,11044880
9129,2020-01-20,1,2,9129000,1917090,11046090
9130,2024-01-31,2,1,9130000,1917300,11047300
9131,2020-01-31,2,3,9131000,1917510,11048510
9132,2020-08-18,2,3,9132000,1917720,11049720
9133,2024-09-26,2,1,9133000,1917930,11050930
9134,2022-01-17,1,1,9134000,1918140,11052140
9135,2023-09-03,3,2,9135000,1918350,11053350
9136,2024-07-03,1,2,9136000,1918560,11054560
9137,2024-01-06,1,2,9137000,1918770,11055770
9138,2021-02-07,1,2,9138000,1918980,11056980
9139,2024-09-15,1,2,9139000,1919190,11058190
9140,2020-10-21,2,3,9140000,1919400,11059400
9141,2023-11-06,3,3,9141000,1919610,11060610
9142,2024-03-12,1,2,9142000,1919820,11061820
9143,2023-04-15,2,1,9143000,1920030,11063030
9144,2023-06-03,1,1,9144000,1920240,11064240
9145,2022-07-08,2,1,9145000,1920450,11065450
9146,2022-04-18,2,3,9146000,1920660,11066660
9147,2024-03-29,2,1,9147000,1920870,11067870
9148,2021-05-21,1,1,9148000,1921080,11069080
9149,2023-01-28,3,2,9149000,1921290,11070290
9150,2024-09-16,2,3,9150000,1921500,11071500
9151,2023-05-13,2,2,9151000,1921710,11072710
9152,2024-03-27,3,2,9152000,1921920,11073920
9153,2023-05-17,1,3,9153000,1922130,11075130
9154,2024-02-03,1,2,9154000,1922340,11076340
9155,2022-11-16,2,1,9155000,1922550,11077550
9156,2023-10-18,3,2,9156000,1922760,11078760
9157,2024-10-31,1,3,9157000,1922970,11079970
9158,2020-08-06,2,3,9158000,1923180,11081180
9159,2020-06-12,3,3,9159000,1923390,11082390
9160,2022-09-23,1,3,9160000,1923600,11083600
9161,2020-02-16,3,1,9161000,1923810,11084810
9162,2021-11-25,2,2,9162000,1924020,11086020
9163,2024-07-27,1,1,9163000,1924230,11087230
9164,2022-11-24,2,2,9164000,1924440,11088440
9165,2023-06-14,1,3,9165000,1924650,11089650
9166,2024-07-26,3,2,9166000,1924860,11090860
9167,2024-12-11,2,3,9167000,1925070,11092070
9168,2020-03-03,1,2,9168000,1925280,11093280
9169,2022-12-17,3,3,9169000,1925490,11094490
9170,2021-03-30,3,3,9170000,1925700,11095700
9171,2021-10-25,1,1,9171000,1925910,11096910
9172,2022-05-30,3,1,9172000,1926120,11098120
9173,2023-02-22,2,1,9173000,1926330,11099330
9174,2020-11-30,2,1,9174000,1926540,11100540
9175,2021-01-10,1,3,9175000,1926750,11101750
9176,2020-11-16,3,3,9176000,1926960,11102960
9177,2022-07-04,3,3,9177000,1927170,11104170
9178,2022-08-09,3,1,9178000,1927380,11105380
9179,2021-11-12,2,3,9179000,1927590,11106590
9180,2024-01-21,1,3,9180000,1927800,11107800
9181,2021-06-02,2,2,9181000,1928010,11109010
9182,2022-11-04,1,1,9182000,1928220,11110220
9183,2024-12-01,2,1,9183000,1928430,11111430
9184,2023-02-03,2,1,9184000,1928640,11112640
9185,2020-10-26,3,2,9185000,1928850,11113850
9186,2024-10-30,2,2,9186000,1929060,11115060
9187,2024-03-25,2,3,9187000,1929270,11116270
9188,2021-12-16,3,1,9188000,1929480,11117480
9189,2022-05-17,3,1,9189000,1929690,11118690
9190,2020-03-24,2,3,9190000,1929900,11119900
9191,2022-06-29,3,3,9191000,1930110,11121110
9192,2022-09-29,2,2,9192000,1930320,11122320
9193,2023-09-07,3,3,9193000,1930530,11123530
9194,2020-06-08,1,3,9194000,1930740,11124740
9195,2020-05-26,3,2,9195000,1930950,11125950
9196,2024-04-06,2,3,9196000,1931160,11127160
9197,2024-05-14,3,3,9197000,1931370,11128370
9198,2023-10-10,3,1,9198000,1931580,11129580
9199,2021-03-22,2,2,9199000,1931790,11130790
9200,2022-02-19,1,1,9200000,1932000,11132000
9201,2021-09-21,2,2,9201000,1932210,11133210
9202,2024-06-25,3,3,9202000,1932420,11134420
9203,2022-12-12,2,3,9203000,1932630,11135630
9204,2023-08-23,3,2,9204000,1932840,11136840
9205,2023-11-15,1,3,9205000,1933050,11138050
9206,2022-06-28,3,1,9206000,1933260,11139260
9207,2022-04-16,1,2,9207000,1933470,11140470
9208,2023-10-30,3,3,9208000,1933680,11141680
9209,2021-01-22,2,3,9209000,1933890,11142890
9210,2020-06-18,2,1,9210000,1934100,11144100
9211,2023-02-07,2,3,9211000,1934310,11145310
9212,2020-05-10,1,3,9212000,1934520,11146520
9213,2024-01-27,2,2,9213000,1934730,11147730
9214,2021-06-07,2,3,9214000,1934940,11148940
9215,2024-06-20,1,1,9215000,1935150,11150150
9216,2021-09-20,2,1,9216000,1935360,11151360
9217,2021-02-04,2,2,9217000,1935570,11152570
9218,2021-10-27,2,1,9218000,1935780,11153780
9219,2021-05-08,2,1,9219000,1935990,11154990
9220,2021-10-03,3,2,9220000,1936200,11156200
9221,2021-01-16,2,1,9221000,1936410,11157410
9222,2022-02-05,3,2,9222000,1936620,11158620
9223,2023-08-22,2,1,9223000,1936830,11159830
9224,2022-09-04,3,2,9224000,1937040,11161040
9225,2020-05-15,2,3,9225000,1937250,11162250
9226,2022-08-09,1,2,9226000,1937460,11163460
9227,2024-12-29,3,1,9227000,1937670,11164670
9228,2022-12-18,2,1,9228000,1937880,11165880
9229,2024-12-23,1,2,9229000,1938090,11167090
9230,2021-09-15,1,3,9230000,1938300,11168300
9231,2024-03-07,3,3,9231000,1938510,11169510
9232,2023-02-24,1,2,9232000,1938720,11170720
9233,2021-01-29,2,1,9233000,1938930,11171930
9234,2024-02-20,3,1,9234000,1939140,11173140
9235,2022-10-01,1,1,9235000,1939350,11174350
9236,2020-03-10,3,3,9236000,1939560,11175560
9237,2021-09-08,2,2,9237000,1939770,11176770
9238,2024-10-05,3,2,9238000,1939980,11177980
9239,2020-09-26,1,2,9239000,1940190,11179190
9240,2020-01-29,3,2,9240000,1940400,11180400
9241,2024-02-29,2,2,9241000,1940610,11181610
9242,2023-01-05,1,3,9242000,1940820,11182820
9243,2022-12-12,3,1,9243000,1941030,11184030
9244,2024-07-10,2,2,9244000,1941240,11185240
9245,2020-10-23,2,3,9245000,1941450,11186450
9246,2022-01-31,2,1,9246000,1941660,11187660
9247,2022-04-17,2,2,9247000,1941870,11188870
9248,2022-05-01,2,1,9248000,1942080,11190080
9249,2020-04-19,1,3,9249000,1942290,11191290
9250,2024-07-18,2,1,9250000,1942500,11192500
9251,2023-02-03,3,3,9251000,1942710,11193710
9252,2020-11-12,1,3,9252000,1942920,11194920
9253,2022-03-26,3,3,9253000,1943130,11196130
9254,2024-11-01,3,2,9254000,1943340,11197340
9255,2022-10-23,3,1,9255000,1943550,11198550
9256,2024-04-13,3,1,9256000,1943760,11199760
9257,2021-05-23,1,3,9257000,1943970,11200970
9258,2020-10-29,2,2,9258000,1944180,11202180
9259,2024-03-05,1,2,9259000,1944390,11203390
9260,2023-01-08,2,3,9260000,1944600,11204600
9261,2021-01-18,3,2,9261000,1944810,11205810
9262,2021-05-13,2,2,9262000,1945020,11207020
9263,2022-09-22,3,1,9263000,1945230,11208230
9264,2022-03-26,3,1,9264000,1945440,11209440
9265,2024-07-08,1,2,9265000,1945650,11210650
9266,2022-04-22,1,2,9266000,1945860,11211860
9267,2021-02-17,3,3,9267000,1946070,11213070
9268,2024-05-22,2,3,9268000,1946280,11214280
9269,2023-04-07,1,2,9269000,1946490,11215490
9270,2020-05-28,3,1,9270000,1946700,11216700
9271,2024-04-24,3,1,9271000,1946910,11217910
9272,2022-10-04,3,1,9272000,1947120,11219120
9273,2024-09-06,1,2,9273000,1947330,11220330
9274,2022-11-11,1,3,9274000,1947540,11221540
9275,2021-04-27,3,1,9275000,1947750,11222750
9276,2022-03-09,3,1,9276000,1947960,11223960
9277,2024-04-21,2,2,9277000,1948170,11225170
9278,2022-10-17,1,2,9278000,1948380,11226380
9279,2023-12-28,1,2,9279000,1948590,11227590
9280,2024-08-18,2,2,9280000,1948800,11228800
9281,2021-12-24,3,3,9281000,1949010,11230010
9282,2023-09-13,1,2,9282000,1949220,11231220
9283,2024-10-29,1,3,9283000,1949430,11232430
9284,2022-05-07,3,2,9284000,1949640,11233640
9285,2021-09-04,3,2,9285000,1949850,11234850
9286,2023-09-04,1,2,9286000,1950060,11236060
9287,2024-12-14,2,2,9287000,1950270,11237270
9288,2021-09-23,3,3,9288000,1950480,11238480
9289,2023-07-01,1,1,9289000,1950690,11239690
9290,2024-08-01,1,2,9290000,1950900,11240900
9291,2022-03-12,2,1,9291000,1951110,11242110
9292,2021-12-18,2,2,9292000,1951320,11243320
9293,2020-03-26,3,2,9293000,1951530,11244530
9294,2021-03-19,1,1,9294000,1951740,11245740
9295,2024-02-16,2,2,9295000,1951950,11246950
9296,2024-10-03,2,2,9296000,1952160,11248160
9297,2022-11-20,3,3,9297000,1952370,11249370
9298,2021-09-01,2,1,9298000,1952580,11250580
9299,2020-05-03,2,3,9299000,1952790,11251790
9300,2024-05-06,2,1,9300000,1953000,11253000
9301,2022-06-10,1,3,9301000,1953210,11254210
9302,2020-03-08,1,1,9302000,1953420,11255420
9303,2022-07-19,3,2,9303000,1953630,11256630
9304,2023-12-07,1,3,9304000,1953840,11257840
9305,2024-06-29,1,2,9305000,1954050,11259050
9306,2024-09-25,1,2,9306000,1954260,11260260
9307,2022-03-21,3,1,9307000,1954470,11261470
9308,2022-06-04,1,2,9308000,1954680,11262680
9309,2024-12-16,1,3,9309000,1954890,11263890
9310,2020-01-04,1,3,9310000,1955100,11265100
9311,2020-06-30,2,3,9311000,1955310,11266310
9312,2020-07-18,2,1,9312000,1955520,11267520
9313,2024-11-24,2,2,9313000,1955730,11268730
9314,2020-12-24,2,1,9314000,1955940,11269940
9315,2023-01-28,3,3,9315000,1956150,11271150
9316,2021-10-14,3,3,9316000,1956360,11272360
9317,2023-12-10,3,2,9317000,1956570,11273570
9318,2021-09-12,1,1,9318000,1956780,11274780
9319,2024-12-28,3,3,9319000,1956990,11275990
9320,2024-06-08,1,3,9320000,1957200,11277200
9321,2024-05-25,1,3,9321000,1957410,11278410
9322,2020-07-19,1,2,9322000,1957620,11279620
9323,2021-03-10,1,2,9323000,1957830,11280830
9324,2022-08-16,3,2,9324000,1958040,11282040
9325,2023-09-19,3,1,9325000,1958250,11283250
9326,2021-02-17,3,1,9326000,1958460,11284460
9327,2020-08-21,2,2,9327000,1958670,11285670
9328,2024-01-16,3,1,9328000,1958880,11286880
9329,2020-09-24,1,3,9329000,1959090,11288090
9330,2022-06-06,2,1,9330000,1959300,11289300
9331,2023-02-03,3,3,9331000,1959510,11290510
9332,2021-02-06,3,3,9332000,1959720,11291720
9333,2020-04-07,3,3,9333000,1959930,11292930
9334,2020-02-27,2,1,9334000,1960140,11294140
9335,2022-07-21,1,3,9335000,1960350,11295350
9336,2021-04-22,1,2,9336000,1960560,11296560
9337,2021-07-14,3,1,9337000,1960770,11297770
9338,2024-01-19,1,2,9338000,1960980,11298980
9339,2022-08-02,2,1,9339000,1961190,11300190
9340,2023-10-15,2,2,9340000,1961400,11301400
9341,2021-03-08,1,3,9341000,1961610,11302610
9342,2023-09-04,2,3,9342000,1961820,11303820
9343,2020-08-30,1,2,9343000,1962030,11305030
9344,2022-03-26,2,3,9344000,1962240,11306240
9345,2022-07-21,1,2,9345000,1962450,11307450
9346,2024-02-26,1,3,9346000,1962660,11308660
9347,2024-04-25,2,3,9347000,1962870,11309870
9348,2021-11-25,2,2,9348000,1963080,11311080
9349,2024-07-25,3,1,9349000,1963290,11312290
9350,2020-10-12,2,3,9350000,1963500,11313500
9351,2020-09-19,1,3,9351000,1963710,11314710
9352,2022-06-09,3,2,9352000,1963920,11315920
9353,2024-01-08,1,1,9353000,1964130,11317130
9354,2023-10-14,2,3,9354000,1964340,11318340
9355,2021-07-29,2,1,9355000,1964550,11319550
9356,2022-03-22,1,1,9356000,1964760,11320760
9357,2020-06-06,2,2,9357000,1964970,11321970
9358,2024-10-31,2,1,9358000,1965180,11323180
9359,2024-03-07,2,2,9359000,1965390,11324390
9360,2022-06-17,1,1,9360000,1965600,11325600
9361,2021-07-10,2,1,9361000,1965810,11326810
9362,2023-01-05,2,1,9362000,1966020,11328020
9363,2020-07-07,1,1,9363000,1966230,11329230
9364,2021-04-04,1,3,9364000,1966440,11330440
9365,2020-10-23,1,2,9365000,1966650,11331650
9366,2024-04-16,3,2,9366000,1966860,11332860
9367,2021-11-09,1,1,9367000,1967070,11334070
9368,2020-02-27,2,1,9368000,1967280,11335280
9369,2023-03-20,2,1,9369000,1967490,11336490
9370,2021-11-14,2,1,9370000,1967700,11337700
9371,2024-10-14,3,3,9371000,1967910,11338910
9372,2023-05-13,1,2,9372000,1968120,11340120
9373,2022-06-28,3,2,9373000,1968330,11341330
9374,2024-12-17,1,3,9374000,1968540,11342540
9375,2024-11-27,1,2,9375000,1968750,11343750
9376,2022-08-15,3,2,9376000,1968960,11344960
9377,2023-11-06,3,2,9377000,1969170,11346170
9378,2021-06-20,3,3,9378000,1969380,11347380
9379,2024-07-30,2,1,9379000,1969590,11348590
9380,2022-05-27,1,1,9380000,1969800,11349800
9381,2022-10-02,1,1,9381000,1970010,11351010
9382,2022-02-18,3,3,9382000,1970220,11352220
9383,2022-06-26,3,1,9383000,1970430,11353430
9384,2020-02-18,1,2,9384000,1970640,11354640
9385,2024-10-20,3,1,9385000,1970850,11355850
9386,2022-02-12,2,3,9386000,1971060,11357060
9387,2020-04-27,3,2,9387000,1971270,11358270
9388,2020-12-09,3,3,9388000,1971480,11359480
9389,2021-10-25,1,2,9389000,1971690,11360690
9390,2022-11-26,2,1,9390000,1971900,11361900
9391,2021-01-11,1,2,9391000,1972110,11363110
9392,2023-05-12,1,3,9392000,1972320,11364320
9393,2022-06-19,1,3,9393000,1972530,11365530
9394,2024-08-04,1,3,9394000,1972740,11366740
9395,2020-10-24,1,3,9395000,1972950,11367950
9396,2020-03-10,3,2,9396000,1973160,11369160
9397,2022-07-17,1,2,9397000,1973370,11370370
9398,2020-05-21,3,3,9398000,1973580,11371580
9399,2022-09-27,1,1,9399000,1973790,11372790
9400,2020-04-15,3,3,9400000,1974000,11374000
9401,2022-07-24,3,2,9401000,1974210,11375210
9402,2024-12-20,3,1,9402000,1974420,11376420
9403,2022-06-16,2,3,9403000,1974630,11377630
9404,2021-10-19,2,2,9404000,1974840,11378840
9405,2020-11-03,1,1,9405000,1975050,11380050
9406,2022-04-14,3,3,9406000,1975260,11381260
9407,2023-11-29,1,1,9407000,1975470,11382470
9408,2024-10-08,2,3,9408000,1975680,11383680
9409,2021-10-26,3,1,9409000,1975890,11384890
9410,2022-04-27,2,1,9410000,1976100,11386100
9411,2023-06-17,1,2,9411000,1976310,11387310
9412,2023-09-15,1,3,9412000,1976520,11388520
9413,2021-07-14,1,2,9413000,1976730,11389730
9414,2022-04-09,2,1,9414000,1976940,11390940
9415,2022-10-28,1,2,9415000,1977150,11392150
9416,2022-01-27,2,1,9416000,1977360,11393360
9417,2020-02-06,2,3,9417000,1977570,11394570
9418,2023-07-26,3,3,9418000,1977780,11395780
9419,2020-11-14,3,2,9419000,1977990,11396990
9420,2024-07-24,3,3,9420000,1978200,11398200
9421,2020-05-01,3,2,9421000,1978410,11399410
9422,2021-05-31,3,2,9422000,1978620,11400620
9423,2022-03-14,3,1,9423000,1978830,11401830
9424,2022-04-08,2,1,9424000,1979040,11403040
9425,2024-09-23,1,3,9425000,1979250,11404250
9426,2020-08-30,3,2,9426000,1979460,11405460
9427,2020-05-16,3,2,9427000,1979670,11406670
9428,2020-04-06,2,1,9428000,1979880,11407880
9429,2023-02-13,1,3,9429000,1980090,11409090
9430,2023-05-25,2,1,9430000,1980300,11410300
9431,2024-10-15,2,2,9431000,1980510,11411510
9432,2024-02-22,3,1,9432000,1980720,11412720
9433,2023-12-08,2,3,9433000,1980930,11413930
9434,2022-12-29,2,3,9434000,1981140,11415140
9435,2021-11-13,1,3,9435000,1981350,11416350
9436,2022-12-15,1,1,9436000,1981560,11417560
9437,2021-10-22,1,1,9437000,1981770,11418770
9438,2023-11-03,2,3,9438000,1981980,11419980
9439,2022-07-15,3,2,9439000,1982190,11421190
9440,2024-05-05,3,1,9440000,1982400,11422400
9441,2022-11-15,3,3,9441000,1982610,11423610
9442,2024-11-16,2,2,9442000,1982820,11424820
9443,2021-11-11,1,1,9443000,1983030,11426030
9444,2023-05-28,2,1,9444000,1983240,11427240
9445,2022-09-14,3,3,9445000,1983450,11428450
9446,2024-03-29,2,2,9446000,1983660,11429660
9447,2022-06-25,1,2,9447000,1983870,11430870
9448,2021-07-27,1,3,9448000,1984080,11432080
9449,2020-10-23,3,1,9449000,1984290,11433290
9450,2022-08-01,1,2,9450000,1984500,11434500
9451,2020-05-28,2,3,9451000,1984710,11435710
9452,2020-11-16,1,2,9452000,1984920,11436920
9453,2023-11-16,2,3,9453000,1985130,11438130
9454,2020-09-15,2,1,9454000,1985340,11439340
9455,2021-07-25,1,2,9455000,1985550,11440550
9456,2022-02-02,2,1,9456000,1985760,11441760
9457,2020-08-22,1,1,9457000,1985970,11442970
9458,2023-12-23,2,1,9458000,1986180,11444180
9459,2022-03-27,3,1,9459000,1986390,11445390
9460,2021-09-15,2,1,9460000,1986600,11446600
9461,2023-01-09,3,2,9461000,1986810,11447810
9462,2020-03-05,1,1,9462000,1987020,11449020
9463,2023-08-08,2,1,9463000,1987230,11450230
9464,2024-12-21,1,2,9464000,1987440,11451440
9465,2022-04-24,1,2,9465000,1987650,11452650
9466,2023-11-17,1,1,9466000,1987860,11453860
9467,2020-10-23,2,1,9467000,1988070,11455070
9468,2021-01-08,1,3,9468000,1988280,11456280
9469,2023-02-09,2,1,9469000,1988490,11457490
9470,2022-07-03,1,1,9470000,1988700,11458700
9471,2023-08-29,2,1,9471000,1988910,11459910
9472,2023-08-08,3,1,9472000,1989120,11461120
9473,2023-03-31,1,3,9473000,1989330,11462330
9474,2020-03-09,2,1,9474000,1989540,11463540
9475,2022-03-27,1,3,9475000,1989750,11464750
9476,2020-02-09,1,3,9476000,1989960,11465960
9477,2020-08-29,1,3,9477000,1990170,11467170
9478,2021-07-18,2,3,9478000,1990380,11468380
9479,2022-08-06,2,3,9479000,1990590,11469590
9480,2024-05-05,1,2,9480000,1990800,11470800
9481,2022-02-08,2,2,9481000,1991010,11472010
9482,2024-01-26,3,2,9482000,1991220,11473220
9483,2023-01-18,2,2,9483000,1991430,11474430
9484,2023-05-17,2,2,9484000,1991640,11475640
9485,2021-07-17,2,3,9485000,1991850,11476850
9486,2022-04-01,2,1,9486000,1992060,11478060
9487,2021-12-01,3,3,9487000,1992270,11479270
9488,2021-10-28,2,3,9488000,1992480,11480480
9489,2020-07-23,2,1,9489000,1992690,11481690
9490,2020-06-26,3,1,9490000,1992900,11482900
9491,2021-02-01,3,2,9491000,1993110,11484110
9492,2023-11-21,3,3,9492000,1993320,11485320
9493,2020-11-19,2,2,9493000,1993530,11486530
9494,2023-03-09,2,3,9494000,1993740,11487740
9495,2023-09-10,1,2,9495000,1993950,11488950
9496,2023-11-19,3,2,9496000,1994160,11490160
9497,2020-06-14,2,1,9497000,1994370,11491370
9498,2023-09-04,3,2,9498000,1994580,11492580
9499,2023-03-24,2,3,9499000,1994790,11493790
9500,2021-06-26,2,3,9500000,1995000,11495000
9501,2023-08-22,3,3,9501000,1995210,11496210
9502,2024-06-10,2,3,9502000,1995420,11497420
9503,2021-03-16,2,1,9503000,1995630,11498630
9504,2021-02-09,1,1,9504000,1995840,11499840
9505,2024-11-01,2,3,9505000,1996050,11501050
9506,2023-06-28,3,2,9506000,1996260,11502260
9507,2020-03-02,2,1,9507000,1996470,11503470
9508,2024-12-05,3,2,9508000,1996680,11504680
9509,2023-11-21,1,1,9509000,1996890,11505890
9510,2023-04-08,2,1,9510000,1997100,11507100
9511,2020-10-26,2,2,9511000,1997310,11508310
9512,2023-05-11,1,3,9512000,1997520,11509520
9513,2020-08-31,3,3,9513000,1997730,11510730
9514,2021-02-26,3,3,9514000,1997940,11511940
9515,2020-09-07,2,2,9515000,1998150,11513150
9516,2022-09-12,3,1,9516000,1998360,11514360
9517,2024-02-14,1,3,9517000,1998570,11515570
9518,2021-05-10,2,2,9518000,1998780,11516780
9519,2021-06-28,2,3,9519000,1998990,11517990
9520,2020-02-25,3,2,9520000,1999200,11519200
9521,2020-04-30,1,3,9521000,1999410,11520410
9522,2021-10-22,1,2,9522000,1999620,11521620
9523,2022-03-24,2,3,9523000,1999830,11522830
9524,2024-09-01,2,3,9524000,2000040,11524040
9525,2024-01-21,1,1,9525000,2000250,11525250
9526,2024-12-08,3,2,9526000,2000460,11526460
9527,2020-02-21,3,1,9527000,2000670,11527670
9528,2021-11-04,3,3,9528000,2000880,11528880
9529,2021-04-12,2,3,9529000,2001090,11530090
9530,2020-02-17,3,3,9530000,2001300,11531300
9531,2023-02-16,2,2,9531000,2001510,11532510
9532,2023-08-14,2,2,9532000,2001720,11533720
9533,2020-08-15,2,3,9533000,2001930,11534930
9534,2021-01-07,2,3,9534000,2002140,11536140
9535,2024-01-26,2,3,9535000,2002350,11537350
9536,2020-05-27,3,2,9536000,2002560,11538560
9537,2022-06-22,1,2,9537000,2002770,11539770
9538,2022-11-05,3,1,9538000,2002980,11540980
9539,2022-05-08,1,1,9539000,2003190,11542190
9540,2022-02-05,2,3,9540000,2003400,11543400
9541,2020-05-11,3,1,9541000,2003610,11544610
9542,2021-04-17,1,1,9542000,2003820,11545820
9543,2020-11-02,3,2,9543000,2004030,11547030
9544,2020-08-06,3,3,9544000,2004240,11548240
9545,2021-05-03,3,3,9545000,2004450,11549450
9546,2020-08-11,1,3,9546000,2004660,11550660
9547,2024-10-17,3,3,9547000,2004870,11551870
9548,2021-04-21,3,3,9548000,2005080,11553080
9549,2020-06-23,1,2,9549000,2005290,11554290
9550,2020-05-28,3,2,9550000,2005500,11555500
9551,2021-02-23,3,1,9551000,2005710,11556710
9552,2023-01-05,1,1,9552000,2005920,11557920
9553,2024-07-24,3,1,9553000,2006130,11559130
9554,2022-01-25,1,1,9554000,2006340,11560340
9555,2023-12-17,3,1,9555000,2006550,11561550
9556,2023-12-19,2,2,9556000,2006760,11562760
9557,2022-05-24,1,1,9557000,2006970,11563970
9558,2020-02-12,3,1,9558000,2007180,11565180
9559,2024-01-02,3,3,9559000,2007390,11566390
9560,2021-02-17,1,2,9560000,2007600,11567600
9561,2023-09-10,1,3,9561000,2007810,11568810
9562,2022-12-17,3,2,9562000,2008020,11570020
9563,2024-01-19,1,3,9563000,2008230,11571230
9564,2021-03-08,1,1,9564000,2008440,11572440
9565,2024-10-31,1,2,9565000,2008650,11573650
9566,2022-08-14,2,2,9566000,2008860,11574860
9567,2024-04-24,2,3,9567000,2009070,11576070
9568,2020-11-14,3,3,9568000,2009280,11577280
9569,2023-05-14,3,2,9569000,2009490,11578490
9570,2024-03-09,2,1,9570000,2009700,11579700
9571,2022-10-31,1,2,9571000,2009910,11580910
9572,2020-10-01,2,3,9572000,2010120,11582120
9573,2024-07-12,2,1,9573000,2010330,11583330
9574,2020-04-14,1,2,9574000,2010540,11584540
9575,2024-11-22,2,3,9575000,2010750,11585750
9576,2023-09-03,3,2,9576000,2010960,11586960
9577,2020-01-05,1,1,9577000,2011170,11588170
9578,2024-02-04,3,2,9578000,2011380,11589380
9579,2024-11-30,3,3,9579000,2011590,11590590
9580,2020-11-03,2,1,9580000,2011800,11591800
9581,2022-01-20,3,2,9581000,2012010,11593010
9582,2024-03-23,1,2,9582000,2012220,11594220
9583,2024-07-24,3,1,9583000,2012430,11595430
9584,2024-11-27,1,2,9584000,2012640,11596640
9585,2020-10-16,1,3,9585000,2012850,11597850
9586,2023-03-28,1,2,9586000,2013060,11599060
9587,2021-01-08,3,1,9587000,2013270,11600270
9588,2021-05-05,3,1,9588000,2013480,11601480
9589,2023-02-18,1,1,9589000,2013690,11602690
9590,2022-12-09,2,2,9590000,2013900,11603900
9591,2021-02-02,1,2,9591000,2014110,11605110
9592,2023-01-21,2,1,9592000,2014320,11606320
9593,2021-08-05,1,2,9593000,2014530,11607530
9594,2024-07-16,2,3,9594000,2014740,11608740
9595,2022-03-21,2,3,9595000,2014950,11609950
9596,2020-09-13,3,3,9596000,2015160,11611160
9597,2021-09-15,3,2,9597000,2015370,11612370
9598,2024-07-20,3,2,9598000,2015580,11613580
9599,2023-01-18,2,2,9599000,2015790,11614790
9600,2021-12-12,3,3,9600000,2016000,11616000
9601,2020-11-18,3,2,9601000,2016210,11617210
9602,2024-08-06,3,3,9602000,2016420,11618420
9603,2023-09-04,2,3,9603000,2016630,11619630
9604,2022-10-11,2,2,9604000,2016840,11620840
9605,2020-08-10,3,1,9605000,2017050,11622050
9606,2023-09-09,1,1,9606000,2017260,11623260
9607,2021-12-09,3,3,9607000,2017470,11624470
9608,2021-02-04,2,3,9608000,2017680,11625680
9609,2022-11-30,1,3,9609000,2017890,11626890
9610,2021-09-30,1,1,9610000,2018100,11628100
9611,2020-03-19,2,2,9611000,2018310,11629310
9612,2023-02-24,3,3,9612000,2018520,11630520
9613,2024-06-06,2,1,9613000,2018730,11631730
9614,2023-07-15,3,2,9614000,2018940,11632940
9615,2020-08-29,3,3,9615000,2019150,11634150
9616,2021-03-12,2,1,9616000,2019360,11635360
9617,2024-10-28,3,3,9617000,2019570,11636570
9618,2020-08-13,3,3,9618000,2019780,11637780
9619,2020-12-20,2,2,9619000,2019990,11638990
9620,2022-05-31,1,2,9620000,2020200,11640200
9621,2020-12-27,2,2,9621000,2020410,11641410
9622,2020-01-16,3,1,9622000,2020620,11642620
9623,2021-05-29,3,3,9623000,2020830,11643830
9624,2022-09-27,3,3,9624000,2021040,11645040
9625,2024-01-07,1,2,9625000,2021250,11646250
9626,2022-02-20,3,1,9626000,2021460,11647460
9627,2024-03-04,1,3,9627000,2021670,11648670
9628,2022-12-20,1,1,9628000,2021880,11649880
9629,2021-05-24,3,3,9629000,2022090,11651090
9630,2020-06-20,1,2,9630000,2022300,11652300
9631,2021-11-30,3,1,9631000,2022510,11653510
9632,2021-11-22,1,3,9632000,2022720,11654720
9633,2021-02-25,3,3,9633000,2022930,11655930
9634,2023-01-26,2,1,9634000,2023140,11657140
9635,2020-06-27,2,2,9635000,2023350,11658350
9636,2021-07-21,2,1,9636000,2023560,11659560
9637,2021-04-12,3,3,9637000,2023770,11660770
9638,2024-04-24,1,1,9638000,2023980,11661980
9639,2022-05-13,2,3,9639000,2024190,11663190
9640,2022-09-07,1,2,9640000,2024400,11664400
9641,2023-05-08,2,2,9641000,2024610,11665610
9642,2020-04-02,3,1,9642000,2024820,11666820
9643,2024-03-10,2,1,9643000,2025030,11668030
9644,2021-10-15,1,1,9644000,2025240,11669240
9645,2022-02-27,1,2,9645000,2025450,11670450
9646,2024-07-08,3,2,9646000,2025660,11671660
9647,2021-12-09,3,1,9647000,2025870,11672870
9648,2023-10-25,1,1,9648000,2026080,11674080
9649,2022-09-06,3,1,9649000,2026290,11675290
9650,2023-06-06,2,2,9650000,2026500,11676500
9651,2024-09-21,1,3,9651000,2026710,11677710
9652,2020-11-03,3,3,9652000,2026920,11678920
9653,2020-08-19,3,2,9653000,2027130,11680130
9654,2024-07-07,3,1,9654000,2027340,11681340
9655,2023-08-05,2,2,9655000,2027550,11682550
9656,2022-03-28,3,2,9656000,2027760,11683760
9657,2022-12-05,1,1,9657000,2027970,11684970
9658,2022-11-25,3,3,9658000,2028180,11686180
9659,2022-05-12,1,3,9659000,2028390,11687390
9660,2022-12-20,2,1,9660000,2028600,11688600
9661,2022-04-29,1,1,9661000,2028810,11689810
9662,2022-02-16,2,2,9662000,2029020,11691020
9663,2021-07-24,1,3,9663000,2029230,11692230
9664,2020-12-31,2,3,9664000,2029440,11693440
9665,2021-03-03,1,1,9665000,2029650,11694650
9666,2022-02-14,3,1,9666000,2029860,11695860
9667,2020-03-14,1,2,9667000,2030070,11697070
9668,2020-09-24,3,3,9668000,2030280,11698280
9669,2024-09-02,3,1,9669000,2030490,11699490
9670,2020-03-23,2,2,9670000,2030700,11700700
9671,2022-11-25,2,3,9671000,2030910,11701910
9672,2024-03-15,2,3,9672000,2031120,11703120
9673,2024-10-18,3,2,9673000,2031330,11704330
9674,2024-02-13,3,1,9674000,2031540,11705540
9675,2022-02-11,3,1,9675000,2031750,11706750
9676,2023-07-30,3,1,9676000,2031960,11707960
9677,2023-11-06,1,3,9677000,2032170,11709170
9678,2024-08-07,2,3,9678000,2032380,11710380
9679,2024-05-04,3,3,9679000,2032590,11711590
9680,2021-02-02,1,3,9680000,2032800,11712800
9681,2020-08-26,2,3,9681000,2033010,11714010
9682,2021-04-28,2,1,9682000,2033220,11715220
9683,2022-02-04,2,1,9683000,2033430,11716430
9684,2020-03-19,2,1,9684000,2033640,11717640
9685,2021-04-06,2,1,9685000,2033850,11718850
9686,2020-12-31,1,2,9686000,2034060,11720060
9687,2022-08-29,2,3,9687000,2034270,11721270
9688,2021-05-30,3,2,9688000,2034480,11722480
9689,2020-10-24,2,3,9689000,2034690,11723690
9690,2024-01-05,1,2,9690000,2034900,11724900
9691,2024-12-03,3,1,9691000,2035110,11726110
9692,2020-04-16,3,1,9692000,2035320,11727320
9693,2020-08-08,2,3,9693000,2035530,11728530
9694,2022-02-13,1,2,9694000,2035740,11729740
9695,2022-06-30,3,3,9695000,2035950,11730950
9696,2023-11-30,1,2,9696000,2036160,11732160
9697,2022-05-12,2,3,9697000,2036370,11733370
9698,2024-10-07,3,3,9698000,2036580,11734580
9699,2022-08-23,2,2,9699000,2036790,11735790
9700,2020-04-22,1,2,9700000,2037000,11737000
9701,2023-10-07,1,2,9701000,2037210,11738210
9702,2022-08-22,1,3,9702000,2037420,11739420
9703,2022-06-19,2,1,9703000,2037630,11740630
9704,2024-02-20,3,2,9704000,2037840,11741840
9705,2020-07-26,1,3,9705000,2038050,11743050
9706,2024-06-05,2,2,9706000,2038260,11744260
9707,2022-06-18,2,3,9707000,2038470,11745470
9708,2020-06-22,1,1,9708000,2038680,11746680
9709,2023-12-28,3,3,9709000,2038890,11747890
9710,2023-10-18,3,1,9710000,2039100,11749100
9711,2022-11-28,1,3,9711000,2039310,11750310
9712,2024-02-16,2,3,9712000,2039520,11751520
9713,2021-06-08,3,1,9713000,2039730,11752730
9714,2024-10-16,1,2,9714000,2039940,11753940
9715,2020-07-31,1,1,9715000,2040150,11755150
9716,2021-05-15,3,2,9716000,2040360,11756360
9717,2022-03-24,2,1,9717000,2040570,11757570
9718,2022-01-08,3,3,9718000,2040780,11758780
9719,2023-11-18,3,3,9719000,2040990,11759990
9720,2022-01-29,1,3,9720000,2041200,11761200
9721,2020-06-02,3,1,9721000,2041410,11762410
9722,2023-06-25,3,2,9722000,2041620,11763620
9723,2024-06-26,2,2,9723000,2041830,11764830
9724,2023-09-08,2,1,9724000,2042040,11766040
9725,2022-02-14,2,2,9725000,2042250,11767250
9726,2024-05-24,2,1,9726000,2042460,11768460
9727,2021-05-23,2,3,9727000,2042670,11769670
9728,2024-11-06,2,3,9728000,2042880,11770880
9729,2020-04-19,3,3,9729000,2043090,11772090
9730,2024-05-22,2,3,9730000,2043300,11773300
9731,2021-07-12,1,3,9731000,2043510,11774510
9732,2024-10-24,1,2,9732000,2043720,11775720
9733,2020-04-23,1,1,9733000,2043930,11776930
9734,2021-03-25,1,3,9734000,2044140,11778140
9735,2023-04-13,1,2,9735000,2044350,11779350
9736,2020-02-02,2,3,9736000,2044560,11780560
9737,2020-06-18,3,1,9737000,2044770,11781770
9738,2021-04-05,1,1,9738000,2044980,11782980
9739,2023-11-22,3,1,9739000,2045190,11784190
9740,2021-10-17,1,1,9740000,2045400,11785400
9741,2021-03-14,1,2,9741000,2045610,11786610
9742,2020-07-23,2,2,9742000,2045820,11787820
9743,2024-01-12,1,2,9743000,2046030,11789030
9744,2023-09-10,2,1,9744000,2046240,11790240
9745,2023-08-11,1,3,9745000,2046450,11791450
9746,2023-02-17,3,3,9746000,2046660,11792660
9747,2022-06-05,1,3,9747000,2046870,11793870
9748,2024-09-27,3,1,9748000,2047080,11795080
9749,2023-03-04,1,2,9749000,2047290,11796290
9750,2022-04-13,3,3,9750000,2047500,11797500
9751,2021-09-02,3,1,9751000,2047710,11798710
9752,2020-09-06,1,2,9752000,2047920,11799920
9753,2021-04-21,2,3,9753000,2048130,11801130
9754,2023-06-17,1,1,9754000,2048340,11802340
9755,2022-09-01,2,2,9755000,2048550,11803550
9756,2020-09-10,1,1,9756000,2048760,11804760
9757,2020-03-11,3,1,9757000,2048970,11805970
9758,2020-03-21,3,2,9758000,2049180,11807180
9759,2020-02-17,1,1,9759000,2049390,11808390
9760,2023-04-25,3,3,9760000,2049600,11809600
9761,2020-08-24,3,3,9761000,2049810,11810810
9762,2023-04-24,2,3,9762000,2050020,11812020
9763,2021-01-13,2,3,9763000,2050230,11813230
9764,2022-05-26,3,2,9764000,2050440,11814440
9765,2021-01-11,1,2,9765000,2050650,11815650
9766,2024-08-22,2,2,9766000,2050860,11816860
9767,2023-02-15,3,3,9767000,2051070,11818070
9768,2024-06-15,3,3,9768000,2051280,11819280
9769,2024-11-25,2,2,9769000,2051490,11820490
9770,2022-05-10,3,1,9770000,2051700,11821700
9771,2021-03-27,1,3,9771000,2051910,11822910
9772,2022-01-17,1,1,9772000,2052120,11824120
9773,2023-09-16,1,2,9773000,2052330,11825330
9774,2024-02-11,3,2,9774000,2052540,11826540
9775,2024-06-07,1,1,9775000,2052750,11827750
9776,2024-12-18,2,1,9776000,2052960,11828960
9777,2021-07-27,3,2,9777000,2053170,11830170
9778,2024-04-04,1,1,9778000,2053380,11831380
9779,2022-03-27,3,1,9779000,2053590,11832590
9780,2022-09-14,3,1,9780000,2053800,11833800
9781,2021-12-10,2,2,9781000,2054010,11835010
9782,2021-08-06,3,3,9782000,2054220,11836220
9783,2022-07-15,1,2,9783000,2054430,11837430
9784,2022-02-09,1,2,9784000,2054640,11838640
9785,2022-05-26,3,2,9785000,2054850,11839850
9786,2022-09-29,2,1,9786000,2055060,11841060
9787,2021-04-30,3,2,9787000,2055270,11842270
9788,2024-11-04,3,3,9788000,2055480,11843480
9789,2024-04-18,1,2,9789000,2055690,11844690
9790,2021-01-15,2,1,9790000,2055900,11845900
9791,2021-12-16,3,1,9791000,2056110,11847110
9792,2020-01-29,1,3,9792000,2056320,11848320
9793,2024-03-01,3,1,9793000,2056530,11849530
9794,2022-05-20,1,1,9794000,2056740,11850740
9795,2024-08-27,2,3,9795000,2056950,11851950
9796,2023-01-11,2,2,9796000,2057160,11853160
9797,2020-10-24,2,1,9797000,2057370,11854370
9798,2020-12-12,1,1,9798000,2057580,11855580
9799,2024-03-13,1,1,9799000,2057790,11856790
9800,2020-05-24,2,3,9800000,2058000,11858000
9801,2024-04-02,2,3,9801000,2058210,11859210
9802,2021-10-25,1,1,9802000,2058420,11860420
9803,2020-02-09,3,1,9803000,2058630,11861630
9804,2021-07-18,3,3,9804000,2058840,11862840
9805,2020-01-29,2,2,9805000,2059050,11864050
9806,2021-10-08,3,3,9806000,2059260,11865260
9807,2022-09-25,2,2,9807000,2059470,11866470
9808,2020-02-03,1,3,9808000,2059680,11867680
9809,2023-07-07,2,2,9809000,2059890,11868890
9810,2023-06-20,2,3,9810000,2060100,11870100
9811,2022-09-05,3,1,9811000,2060310,11871310
9812,2020-01-26,3,3,9812000,2060520,11872520
9813,2023-09-14,2,1,9813000,2060730,11873730
9814,2020-12-11,3,2,9814000,2060940,11874940
9815,2022-07-29,1,3,9815000,2061150,11876150
9816,2021-09-07,3,2,9816000,2061360,11877360
9817,2024-12-20,2,3,9817000,2061570,11878570
9818,2023-08-31,2,3,9818000,2061780,11879780
9819,2022-06-15,2,3,9819000,2061990,11880990
9820,2024-02-07,3,1,9820000,2062200,11882200
9821,2022-01-11,3,1,9821000,2062410,11883410
9822,2024-08-25,2,1,9822000,2062620,11884620
9823,2020-01-25,1,1,9823000,2062830,11885830
9824,2021-09-08,1,3,9824000,2063040,11887040
9825,2020-09-20,3,1,9825000,2063250,11888250
9826,2021-11-08,3,3,9826000,2063460,11889460
9827,2021-10-24,1,3,9827000,2063670,11890670
9828,2023-01-28,3,2,9828000,2063880,11891880
9829,2024-11-06,1,3,9829000,2064090,11893090
9830,2021-07-21,3,3,9830000,2064300,11894300
9831,2020-06-11,2,1,9831000,2064510,11895510
9832,2021-06-28,3,3,9832000,2064720,11896720
9833,2023-08-10,2,3,9833000,2064930,11897930
9834,2021-07-19,2,3,9834000,2065140,11899140
9835,2022-08-29,3,3,9835000,2065350,11900350
9836,2024-07-14,1,1,9836000,2065560,11901560
9837,2021-10-17,3,3,9837000,2065770,11902770
9838,2021-04-06,3,1,9838000,2065980,11903980
9839,2021-05-03,3,3,9839000,2066190,11905190
9840,2020-09-29,2,2,9840000,2066400,11906400
9841,2023-02-15,1,2,9841000,2066610,11907610
9842,2022-04-01,1,3,9842000,2066820,11908820
9843,2021-04-25,2,3,9843000,2067030,11910030
9844,2023-03-06,2,2,9844000,2067240,11911240
9845,2022-04-13,2,1,9845000,2067450,11912450
9846,2021-09-30,1,1,9846000,2067660,11913660
9847,2020-03-26,1,2,9847000,2067870,11914870
9848,2022-04-07,2,3,9848000,2068080,11916080
9849,2021-11-09,1,1,9849000,2068290,11917290
9850,2024-08-24,3,1,9850000,2068500,11918500
9851,2021-08-01,2,2,9851000,2068710,11919710
9852,2022-04-08,3,2,9852000,2068920,11920920
9853,2021-01-13,1,2,9853000,2069130,11922130
9854,2024-01-05,1,1,9854000,2069340,11923340
9855,2022-04-12,2,1,9855000,2069550,11924550
9856,2022-09-07,3,2,9856000,2069760,11925760
9857,2023-03-28,3,2,9857000,2069970,11926970
9858,2020-12-25,2,3,9858000,2070180,11928180
9859,2024-02-23,3,3,9859000,2070390,11929390
9860,2023-06-05,1,3,9860000,2070600,11930600
9861,2024-04-03,3,2,9861000,2070810,11931810
9862,2021-08-13,2,1,9862000,2071020,11933020
9863,2022-02-02,1,3,9863000,2071230,11934230
9864,2020-11-25,3,3,9864000,2071440,11935440
9865,2022-11-05,3,3,9865000,2071650,11936650
9866,2021-05-20,3,2,9866000,2071860,11937860
9867,2021-01-16,1,3,9867000,2072070,11939070
9868,2023-10-02,1,2,9868000,2072280,11940280
9869,2021-12-22,2,2,9869000,2072490,11941490
9870,2022-07-27,3,3,9870000,2072700,11942700
9871,2023-11-26,1,3,9871000,2072910,11943910
9872,2022-09-13,3,1,9872000,2073120,11945120
9873,2020-10-17,1,1,9873000,2073330,11946330
9874,2020-05-18,2,1,9874000,2073540,11947540
9875,2020-06-22,3,1,9875000,2073750,11948750
9876,2023-01-06,1,1,9876000,2073960,11949960
9877,2023-10-29,3,1,9877000,2074170,11951170
9878,2021-01-31,2,1,9878000,2074380,11952380
9879,2020-04-03,3,1,9879000,2074590,11953590
9880,2024-02-15,2,1,9880000,2074800,11954800
9881,2021-10-23,1,1,9881000,2075010,11956010
9882,2024-10-06,3,3,9882000,2075220,11957220
9883,2024-11-14,2,2,9883000,2075430,11958430
9884,2023-01-23,2,1,9884000,2075640,11959640
9885,2023-09-05,3,3,9885000,2075850,11960850
9886,2020-08-26,2,1,9886000,2076060,11962060
9887,2022-01-19,3,3,9887000,2076270,11963270
9888,2022-04-29,2,2,9888000,2076480,11964480
9889,2024-02-20,2,3,9889000,2076690,11965690
9890,2023-02-03,2,3,9890000,2076900,11966900
9891,2022-01-30,3,1,9891000,2077110,11968110
9892,2022-12-08,3,1,9892000,2077320,11969320
9893,2021-12-10,3,1,9893000,2077530,11970530
9894,2020-10-14,2,3,9894000,2077740,11971740
9895,2024-04-10,3,2,9895000,2077950,11972950
9896,2021-07-18,1,2,9896000,2078160,11974160
9897,2023-01-30,1,2,9897000,2078370,11975370
9898,2020-05-30,3,2,9898000,2078580,11976580
9899,2020-07-07,2,2,9899000,2078790,11977790
9900,2024-05-11,1,2,9900000,2079000,11979000
9901,2024-02-29,2,2,9901000,2079210,11980210
9902,2024-05-18,1,3,9902000,2079420,11981420
9903,2022-04-02,3,3,9903000,2079630,11982630
9904,2023-05-13,1,3,9904000,2079840,11983840
9905,2020-07-08,3,1,9905000,2080050,11985050
9906,2021-12-01,1,2,9906000,2080260,11986260
9907,2020-02-15,2,1,9907000,2080470,11987470
9908,2023-05-04,1,3,9908000,2080680,11988680
9909,2021-09-25,3,2,9909000,2080890,11989890
9910,2022-10-20,1,2,9910000,2081100,11991100
9911,2023-06-03,2,3,9911000,2081310,11992310
9912,2022-01-13,1,3,9912000,2081520,11993520
9913,2021-02-07,3,1,9913000,2081730,11994730
9914,2023-10-21,1,2,9914000,2081940,11995940
9915,2024-09-26,1,1,9915000,2082150,11997150
9916,2022-10-13,3,2,9916000,2082360,11998360
9917,2022-10-13,1,1,9917000,2082570,11999570
9918,2020-11-16,1,1,9918000,2082780,12000780
9919,2020-10-08,3,3,9919000,2082990,12001990
9920,2021-02-23,2,3,9920000,2083200,12003200
9921,2022-03-27,1,3,9921000,2083410,12004410
9922,2021-03-21,1,3,9922000,2083620,12005620
9923,2024-12-01,3,3,9923000,2083830,12006830
9924,2023-11-19,2,1,9924000,2084040,12008040
9925,2022-01-01,2,1,9925000,2084250,12009250
9926,2021-04-10,3,3,9926000,2084460,12010460
9927,2021-09-13,3,1,9927000,2084670,12011670
9928,2020-05-12,2,1,9928000,2084880,12012880
9929,2020-06-01,1,1,9929000,2085090,12014090
9930,2020-12-02,3,2,9930000,2085300,12015300
9931,2024-10-17,3,3,9931000,2085510,12016510
9932,2020-06-22,1,1,9932000,2085720,12017720
9933,2023-11-22,1,1,9933000,2085930,12018930
9934,2020-09-16,1,1,9934000,2086140,12020140
9935,2020-11-18,2,2,9935000,2086350,12021350
9936,2024-05-15,3,3,9936000,2086560,12022560
9937,2023-12-04,3,2,9937000,2086770,12023770
9938,2022-03-25,3,3,9938000,2086980,12024980
9939,2021-05-13,2,3,9939000,2087190,12026190
9940,2024-06-05,1,1,9940000,2087400,12027400
9941,2023-01-20,2,1,9941000,2087610,12028610
9942,2021-11-09,1,1,9942000,2087820,12029820
9943,2023-01-01,2,1,9943000,2088030,12031030
9944,2021-12-22,2,3,9944000,2088240,12032240
9945,2023-03-22,3,2,9945000,2088450,12033450
9946,2020-09-30,1,2,9946000,2088660,12034660
9947,2022-03-25,3,3,9947000,2088870,12035870
9948,2023-06-19,3,2,9948000,2089080,12037080
9949,2021-12-13,2,1,9949000,2089290,12038290
9950,2023-02-22,3,1,9950000,2089500,12039500
9951,2022-08-25,1,1,9951000,2089710,12040710
9952,2020-06-19,3,2,9952000,2089920,12041920
9953,2022-07-07,3,3,9953000,2090130,12043130
9954,2023-02-19,1,3,9954000,2090340,12044340
9955,2020-02-02,1,1,9955000,2090550,12045550
9956,2020-12-24,3,2,9956000,2090760,12046760
9957,2022-05-11,2,2,9957000,2090970,12047970
9958,2022-04-02,1,3,9958000,2091180,12049180
9959,2022-01-01,1,1,9959000,2091390,12050390
9960,2024-01-25,2,2,9960000,2091600,12051600
9961,2022-04-04,2,2,9961000,2091810,12052810
9962,2022-05-20,2,3,9962000,2092020,12054020
9963,2022-11-09,1,3,9963000,2092230,12055230
9964,2024-11-11,3,2,9964000,2092440,12056440
9965,2020-08-06,1,3,9965000,2092650,12057650
9966,2021-01-22,3,3,9966000,2092860,12058860
9967,2022-04-10,3,1,9967000,2093070,12060070
9968,2023-07-29,1,3,9968000,2093280,12061280
9969,2022-02-12,1,2,9969000,2093490,12062490
9970,2020-07-25,1,1,9970000,2093700,12063700
9971,2023-02-16,2,1,9971000,2093910,12064910
9972,2020-03-01,3,2,9972000,2094120,12066120
9973,2023-11-17,2,3,9973000,2094330,12067330
9974,2023-07-28,1,2,9974000,2094540,12068540
9975,2024-10-30,3,1,9975000,2094750,12069750
9976,2020-11-04,2,2,9976000,2094960,12070960
9977,2022-06-15,3,3,9977000,2095170,12072170
9978,2022-12-08,3,3,9978000,2095380,12073380
9979,2023-06-19,1,2,9979000,2095590,12074590
9980,2022-11-25,2,2,9980000,2095800,12075800
9981,2022-11-23,1,2,9981000,2096010,12077010
9982,2021-08-22,2,1,9982000,2096220,12078220
9983,2020-08-17,2,2,9983000,2096430,12079430
9984,2020-08-31,2,3,9984000,2096640,12080640
9985,2024-09-16,1,2,9985000,2096850,12081850
9986,2024-11-20,1,1,9986000,2097060,12083060
9987,2020-12-21,1,2,9987000,2097270,12084270
9988,2021-07-24,1,1,9988000,2097480,12085480
9989,2020-11-12,3,3,9989000,2097690,12086690
9990,2021-07-05,3,1,9990000,2097900,12087900
9991,2022-06-14,2,3,9991000,2098110,12089110
9992,2023-07-01,3,1,9992000,2098320,12090320
9993,2020-01-14,1,1,9993000,2098530,12091530
9994,2020-08-18,2,2,9994000,2098740,12092740
9995,2021-01-30,3,1,9995000,2098950,12093950
9996,2021-06-24,2,3,9996000,2099160,12095160
9997,2023-01-23,1,1,9997000,2099370,12096370
9998,2021-05-13,1,3,9998000,2099580,12097580
9999,2024-04-21,2,3,9999000,2099790,12098790
10000,2021-09-11,3,3,10000000,2100000,12100000